area,name,abbrev,year,alldeaths_inpatient_age75,estimated_potential,eligible,donors,organs,potential_pct,eligible_per_100potential,donors_per_100potential,organs_per_100potential,tx_per_100potential,organ_potential,organ_share,conversion_rate,collabrate,alldonors,allorgans,alltx,dcdorgans,dbdorgans,dbddonors,dcddonors,dbddonor_pct,dcddonor_pct,dbdorgan_pct,dcdorgan_pct,dbdtx,dcdtx,dbdtx_pct,dcdtx_pct,seq
 ALOB-OP1 Alabama Organ Center,Alabama Organ Center,ALOB,1999,9787,570,,85,292,6,,15,51,47,1600,18,,,85,292,85,2,290,84,1,99,1,99,1,84,1,99,1,1
 ALOB-OP1 Alabama Organ Center,Alabama Organ Center,ALOB,2000,9878,535,,126,476,5,,24,89,77,1501,32,,,126,476,126,4,472,124,2,98,2,99,1,124,2,98,2,2
 ALOB-OP1 Alabama Organ Center,Alabama Organ Center,ALOB,2001,9871,542,,120,401,5,,22,74,60,1514,26,,,120,401,120,4,397,118,2,98,2,99,1,118,2,98,2,3
 ALOB-OP1 Alabama Organ Center,Alabama Organ Center,ALOB,2002,9655,561,,100,349,6,,18,62,55,1566,22,,,100,349,100,17,332,92,8,92,8,95,5,92,8,92,8,4
 ALOB-OP1 Alabama Organ Center,Alabama Organ Center,ALOB,2003,9654,525,,89,355,5,,17,68,62,1471,24,,,89,355,89,0,355,89,0,100,0,100,0,89,0,100,0,5
 ALOB-OP1 Alabama Organ Center,Alabama Organ Center,ALOB,2004,9513,534,,80,275,6,,15,51,43,1491,18,,,80,275,80,8,267,77,3,96,4,97,3,77,3,96,4,6
 ALOB-OP1 Alabama Organ Center,Alabama Organ Center,ALOB,2005,9641,600,,101,318,6,,17,53,48,1660,19,,,101,318,101,7,311,98,3,97,3,98,2,98,3,97,3,7
 ALOB-OP1 Alabama Organ Center,Alabama Organ Center,ALOB,2006,9417,557,,119,434,6,,21,78,68,1541,28,,,119,434,119,13,421,114,5,96,4,97,3,114,5,96,4,8
 ALOB-OP1 Alabama Organ Center,Alabama Organ Center,ALOB,2007,9488,575,,155,480,6,,27,83,69,1587,30,,,155,480,155,24,456,143,12,92,8,95,5,143,12,92,8,9
 ALOB-OP1 Alabama Organ Center,Alabama Organ Center,ALOB,2008,9620,574,120,131,445,6,21,23,77,64,1589,28,,,131,445,131,20,425,123,8,94,6,96,4,123,8,94,6,10
 ALOB-OP1 Alabama Organ Center,Alabama Organ Center,ALOB,2009,9343,580,112,122,381,6,19,21,66,52,1606,24,,,122,381,122,25,356,112,10,92,8,93,7,112,10,92,8,11
 ALOB-OP1 Alabama Organ Center,Alabama Organ Center,ALOB,2010,9525,574,144,138,470,6,25,24,82,69,1578,30,,,138,470,138,28,442,125,13,91,9,94,6,125,13,91,9,12
 ALOB-OP1 Alabama Organ Center,Alabama Organ Center,ALOB,2011,9422,555,149,110,392,6,27,20,71,60,1532,26,67,69,110,392,110,5,387,108,2,98,2,99,1,108,2,98,2,13
 ALOB-OP1 Alabama Organ Center,Alabama Organ Center,ALOB,2012,9655,600,163,110,365,6,27,18,61,53,1652,22,59,62,110,365,110,13,352,104,6,95,5,96,4,104,6,95,5,14
 ALOB-OP1 Alabama Organ Center,Alabama Organ Center,ALOB,2013,9647,539,147,104,354,6,27,19,66,56,1495,24,63,65,104,354,104,14,340,99,5,95,5,96,4,99,5,95,5,15
 ALOB-OP1 Alabama Organ Center,Alabama Organ Center,ALOB,2014,9618,526,171,123,394,5,33,23,75,64,1455,27,65,67,123,394,123,10,384,118,5,96,4,97,3,118,5,96,4,16
 ALOB-OP1 Alabama Organ Center,Alabama Organ Center,ALOB,2015,9687,549,169,128,406,6,31,23,74,63,1525,27,67,70,128,406,128,25,381,118,10,92,8,94,6,118,10,92,8,17
 ALOB-OP1 Alabama Organ Center,Alabama Organ Center,ALOB,2016,12386,803,191,153,505,6,24,19,63,53,2199,23,71,73,153,505,153,26,479,141,12,92,8,95,5,141,12,92,8,18
 AROR-OP1 Arkansas Reg. Organ Recovery Agency,Arkansas Reg. Organ Recovery Agency,AROR,1999,4943,273,,36,118,6,,13,43,36,772,15,,,36,118,36,0,118,36,0,100,0,100,0,36,0,100,0,19
 AROR-OP1 Arkansas Reg. Organ Recovery Agency,Arkansas Reg. Organ Recovery Agency,AROR,2000,5048,281,,33,140,6,,12,50,46,790,18,,,33,140,33,0,140,33,0,100,0,100,0,33,0,100,0,20
 AROR-OP1 Arkansas Reg. Organ Recovery Agency,Arkansas Reg. Organ Recovery Agency,AROR,2001,5014,266,,33,118,5,,12,44,38,749,16,,,33,118,33,0,118,33,0,100,0,100,0,33,0,100,0,21
 AROR-OP1 Arkansas Reg. Organ Recovery Agency,Arkansas Reg. Organ Recovery Agency,AROR,2002,5220,284,,54,211,5,,19,74,63,793,27,,,54,211,54,0,211,54,0,100,0,100,0,54,0,100,0,22
 AROR-OP1 Arkansas Reg. Organ Recovery Agency,Arkansas Reg. Organ Recovery Agency,AROR,2003,4976,256,,44,170,5,,17,67,59,714,24,,,44,170,44,0,170,44,0,100,0,100,0,44,0,100,0,23
 AROR-OP1 Arkansas Reg. Organ Recovery Agency,Arkansas Reg. Organ Recovery Agency,AROR,2004,4860,284,,64,256,6,,23,90,75,789,32,,,64,256,64,3,253,63,1,98,2,99,1,63,1,98,2,24
 AROR-OP1 Arkansas Reg. Organ Recovery Agency,Arkansas Reg. Organ Recovery Agency,AROR,2005,4624,251,,70,271,5,,28,108,96,691,39,,,70,271,70,0,271,70,0,100,0,100,0,70,0,100,0,25
 AROR-OP1 Arkansas Reg. Organ Recovery Agency,Arkansas Reg. Organ Recovery Agency,AROR,2006,4567,255,,77,305,6,,30,120,104,706,43,,,77,305,77,11,294,74,3,96,4,96,4,74,3,96,4,26
 AROR-OP1 Arkansas Reg. Organ Recovery Agency,Arkansas Reg. Organ Recovery Agency,AROR,2007,4317,268,,78,273,6,,29,102,86,740,37,,,78,273,78,4,269,76,2,97,3,99,1,76,2,97,3,27
 AROR-OP1 Arkansas Reg. Organ Recovery Agency,Arkansas Reg. Organ Recovery Agency,AROR,2008,4572,272,87,57,230,6,32,21,85,74,754,30,,,57,230,57,5,225,56,1,98,2,98,2,56,1,98,2,28
 AROR-OP1 Arkansas Reg. Organ Recovery Agency,Arkansas Reg. Organ Recovery Agency,AROR,2009,4482,285,94,69,261,6,33,24,92,76,790,33,,,69,261,69,2,259,68,1,99,1,99,1,68,1,99,1,29
 AROR-OP1 Arkansas Reg. Organ Recovery Agency,Arkansas Reg. Organ Recovery Agency,AROR,2010,4250,246,76,58,227,6,31,24,92,80,685,33,,,58,227,58,6,221,56,2,97,3,97,3,56,2,97,3,30
 AROR-OP1 Arkansas Reg. Organ Recovery Agency,Arkansas Reg. Organ Recovery Agency,AROR,2011,4294,268,85,67,237,6,32,25,89,76,736,32,72,74,67,237,67,13,224,62,5,93,7,95,5,62,5,93,7,31
 AROR-OP1 Arkansas Reg. Organ Recovery Agency,Arkansas Reg. Organ Recovery Agency,AROR,2012,4372,262,79,67,241,6,30,26,92,78,726,33,76,78,67,241,67,14,227,62,5,93,7,94,6,62,5,93,7,32
 AROR-OP1 Arkansas Reg. Organ Recovery Agency,Arkansas Reg. Organ Recovery Agency,AROR,2013,4457,258,83,63,234,6,32,24,91,79,711,33,69,71,63,234,63,13,221,58,5,92,8,94,6,58,5,92,8,33
 AROR-OP1 Arkansas Reg. Organ Recovery Agency,Arkansas Reg. Organ Recovery Agency,AROR,2014,4510,240,73,64,248,5,30,27,103,84,667,37,81,82,64,248,64,10,238,59,5,92,8,96,4,59,5,92,8,34
 AROR-OP1 Arkansas Reg. Organ Recovery Agency,Arkansas Reg. Organ Recovery Agency,AROR,2015,4438,274,74,62,223,6,27,23,81,66,757,29,73,76,62,223,62,15,208,56,6,90,10,93,7,56,6,90,10,35
 AROR-OP1 Arkansas Reg. Organ Recovery Agency,Arkansas Reg. Organ Recovery Agency,AROR,2016,4496,286,72,63,245,6,25,22,86,74,795,31,72,76,63,245,63,25,220,53,10,84,16,90,10,53,10,84,16,36
 AZOB-OP1 Donor Network of Arizona,Donor Network of Arizona,AZOB,1999,7669,444,,76,246,6,,17,55,51,1225,20,,,76,246,76,0,246,76,0,100,0,100,0,76,0,100,0,37
 AZOB-OP1 Donor Network of Arizona,Donor Network of Arizona,AZOB,2000,7264,435,,74,272,6,,17,63,58,1200,23,,,74,272,74,0,272,74,0,100,0,100,0,74,0,100,0,38
 AZOB-OP1 Donor Network of Arizona,Donor Network of Arizona,AZOB,2001,7033,408,,70,238,6,,17,58,55,1123,21,,,70,238,70,0,238,70,0,100,0,100,0,70,0,100,0,39
 AZOB-OP1 Donor Network of Arizona,Donor Network of Arizona,AZOB,2002,7185,405,,82,302,6,,20,75,71,1109,27,,,82,302,82,0,302,82,0,100,0,100,0,82,0,100,0,40
 AZOB-OP1 Donor Network of Arizona,Donor Network of Arizona,AZOB,2003,7028,374,,69,257,5,,18,69,66,1020,25,,,69,257,69,0,257,69,0,100,0,100,0,69,0,100,0,41
 AZOB-OP1 Donor Network of Arizona,Donor Network of Arizona,AZOB,2004,6972,399,,76,276,6,,19,69,67,1086,25,,,76,276,76,3,273,75,1,99,1,99,1,75,1,99,1,42
 AZOB-OP1 Donor Network of Arizona,Donor Network of Arizona,AZOB,2005,7189,440,,124,434,6,,28,99,88,1204,36,,,124,434,124,6,428,122,2,98,2,99,1,122,2,98,2,43
 AZOB-OP1 Donor Network of Arizona,Donor Network of Arizona,AZOB,2006,7048,428,,113,436,6,,26,102,94,1160,38,,,113,436,113,20,416,106,7,94,6,95,5,106,7,94,6,44
 AZOB-OP1 Donor Network of Arizona,Donor Network of Arizona,AZOB,2007,6776,461,,143,565,7,,31,122,111,1253,45,,,143,565,143,17,548,137,6,96,4,97,3,137,6,96,4,45
 AZOB-OP1 Donor Network of Arizona,Donor Network of Arizona,AZOB,2008,6930,427,174,124,467,6,41,29,109,101,1163,40,,,124,467,124,25,442,114,10,92,8,95,5,114,10,92,8,46
 AZOB-OP1 Donor Network of Arizona,Donor Network of Arizona,AZOB,2009,6832,408,139,114,411,6,34,28,101,90,1113,37,,,114,411,114,46,365,97,17,85,15,89,11,97,17,85,15,47
 AZOB-OP1 Donor Network of Arizona,Donor Network of Arizona,AZOB,2010,6528,424,159,119,453,6,37,28,107,99,1158,39,,,119,453,119,35,418,105,14,88,12,92,8,105,14,88,12,48
 AZOB-OP1 Donor Network of Arizona,Donor Network of Arizona,AZOB,2011,6383,432,179,168,596,7,41,39,138,130,1175,51,77,80,168,596,168,58,538,145,23,86,14,90,10,145,23,86,14,49
 AZOB-OP1 Donor Network of Arizona,Donor Network of Arizona,AZOB,2012,6513,424,162,143,511,7,38,34,120,103,1151,44,69,74,143,511,143,58,453,121,22,85,15,89,11,121,22,85,15,50
 AZOB-OP1 Donor Network of Arizona,Donor Network of Arizona,AZOB,2013,6661,437,189,180,631,7,43,41,144,129,1192,53,68,75,180,631,180,113,518,135,45,75,25,82,18,135,45,75,25,51
 AZOB-OP1 Donor Network of Arizona,Donor Network of Arizona,AZOB,2014,6977,447,154,158,564,6,34,35,126,110,1219,46,70,77,158,564,158,117,447,115,43,73,27,79,21,115,43,73,27,52
 AZOB-OP1 Donor Network of Arizona,Donor Network of Arizona,AZOB,2015,7084,487,164,166,608,7,34,34,125,106,1328,46,72,78,166,608,166,101,507,127,39,77,23,83,17,127,39,77,23,53
 AZOB-OP1 Donor Network of Arizona,Donor Network of Arizona,AZOB,2016,7670,533,226,224,809,7,42,42,152,135,1457,56,70,77,224,809,224,143,666,175,49,78,22,82,18,175,49,78,22,54
 CADN-OP1 Donor Network West,Donor Network West,CADN,1999,15064,905,,209,773,6,,23,85,79,2530,31,,,209,773,209,0,773,209,0,100,0,100,0,209,0,100,0,55
 CADN-OP1 Donor Network West,Donor Network West,CADN,2000,15129,862,,190,709,6,,22,82,77,2415,29,,,190,709,190,3,706,189,1,99,1,100,0,189,1,99,1,56
 CADN-OP1 Donor Network West,Donor Network West,CADN,2001,15359,845,,213,825,6,,25,98,90,2367,35,,,213,825,213,2,823,212,1,100,0,100,0,212,1,100,0,57
 CADN-OP1 Donor Network West,Donor Network West,CADN,2002,15402,889,,227,989,6,,26,111,103,2477,40,,,227,989,227,0,989,227,0,100,0,100,0,227,0,100,0,58
 CADN-OP1 Donor Network West,Donor Network West,CADN,2003,15224,887,,248,1037,6,,28,117,109,2459,42,,,248,1037,248,8,1029,245,3,99,1,99,1,245,3,99,1,59
 CADN-OP1 Donor Network West,Donor Network West,CADN,2004,14669,874,,254,1058,6,,29,121,111,2415,44,,,254,1058,254,2,1056,253,1,100,0,100,0,253,1,100,0,60
 CADN-OP1 Donor Network West,Donor Network West,CADN,2005,14602,907,,282,1172,6,,31,129,116,2507,47,,,282,1172,282,24,1148,275,7,98,2,98,2,275,7,98,2,61
 CADN-OP1 Donor Network West,Donor Network West,CADN,2006,14484,903,,280,1137,6,,31,126,113,2484,46,,,280,1137,280,45,1092,266,14,95,5,96,4,266,14,95,5,62
 CADN-OP1 Donor Network West,Donor Network West,CADN,2007,14695,900,,279,1123,6,,31,125,110,2476,45,,,279,1123,279,46,1077,262,17,94,6,96,4,262,17,94,6,63
 CADN-OP1 Donor Network West,Donor Network West,CADN,2008,14409,874,372,266,1044,6,43,30,119,109,2401,43,,,266,1044,266,22,1022,257,9,97,3,98,2,257,9,97,3,64
 CADN-OP1 Donor Network West,Donor Network West,CADN,2009,14317,878,399,266,991,6,45,30,113,100,2417,41,,,266,991,266,19,972,259,7,97,3,98,2,259,7,97,3,65
 CADN-OP1 Donor Network West,Donor Network West,CADN,2010,13684,887,374,274,1036,6,42,31,117,107,2435,43,,,274,1036,274,48,988,254,20,93,7,95,5,254,20,93,7,66
 CADN-OP1 Donor Network West,Donor Network West,CADN,2011,13766,924,380,299,1163,7,41,32,126,116,2526,46,68,71,299,1163,299,75,1088,271,28,91,9,94,6,271,28,91,9,67
 CADN-OP1 Donor Network West,Donor Network West,CADN,2012,13589,863,370,305,1149,6,43,35,133,122,2375,48,74,76,305,1149,305,56,1093,284,21,93,7,95,5,284,21,93,7,68
 CADN-OP1 Donor Network West,Donor Network West,CADN,2013,13643,843,352,281,1018,6,42,33,121,109,2320,44,70,73,281,1018,281,66,952,257,24,91,9,94,6,257,24,91,9,69
 CADN-OP1 Donor Network West,Donor Network West,CADN,2014,14060,862,374,305,1135,6,43,35,132,117,2371,48,70,73,305,1135,305,45,1090,286,19,94,6,96,4,286,19,94,6,70
 CADN-OP1 Donor Network West,Donor Network West,CADN,2015,14318,898,336,300,1066,6,37,33,119,104,2469,43,71,76,300,1066,300,82,984,268,32,89,11,92,8,268,32,89,11,71
 CADN-OP1 Donor Network West,Donor Network West,CADN,2016,14918,947,371,291,1093,6,39,31,115,101,2611,42,65,69,291,1093,291,102,991,253,38,87,13,91,9,253,38,87,13,72
 CAGS-OP1 Sierra Donor Services,Sierra Donor Services,CAGS,1999,3467,203,,46,172,6,,23,85,69,573,30,,,46,172,46,0,172,46,0,100,0,100,0,46,0,100,0,73
 CAGS-OP1 Sierra Donor Services,Sierra Donor Services,CAGS,2000,3445,211,,43,161,6,,20,76,70,593,27,,,43,161,43,6,155,41,2,95,5,96,4,41,2,95,5,74
 CAGS-OP1 Sierra Donor Services,Sierra Donor Services,CAGS,2001,3542,193,,22,81,5,,11,42,40,540,15,,,22,81,22,0,81,22,0,100,0,100,0,22,0,100,0,75
 CAGS-OP1 Sierra Donor Services,Sierra Donor Services,CAGS,2002,3645,211,,44,147,6,,21,70,66,591,25,,,44,147,44,5,142,42,2,95,5,97,3,42,2,95,5,76
 CAGS-OP1 Sierra Donor Services,Sierra Donor Services,CAGS,2003,3588,218,,52,169,6,,24,78,72,601,28,,,52,169,52,11,158,47,5,90,10,93,7,47,5,90,10,77
 CAGS-OP1 Sierra Donor Services,Sierra Donor Services,CAGS,2004,3525,220,,46,162,6,,21,74,66,610,27,,,46,162,46,17,145,39,7,85,15,90,10,39,7,85,15,78
 CAGS-OP1 Sierra Donor Services,Sierra Donor Services,CAGS,2005,3474,208,,61,220,6,,29,106,97,578,38,,,61,220,61,2,218,60,1,98,2,99,1,60,1,98,2,79
 CAGS-OP1 Sierra Donor Services,Sierra Donor Services,CAGS,2006,3482,225,,81,250,6,,36,111,101,615,41,,,81,250,81,13,237,74,7,91,9,95,5,74,7,91,9,80
 CAGS-OP1 Sierra Donor Services,Sierra Donor Services,CAGS,2007,3464,209,,56,178,6,,27,85,76,574,31,,,56,178,56,4,174,54,2,96,4,98,2,54,2,96,4,81
 CAGS-OP1 Sierra Donor Services,Sierra Donor Services,CAGS,2008,3372,218,69,58,184,6,32,27,84,77,599,31,,,58,184,58,14,170,51,7,88,12,92,8,51,7,88,12,82
 CAGS-OP1 Sierra Donor Services,Sierra Donor Services,CAGS,2009,3338,202,63,49,169,6,31,24,84,75,552,31,,,49,169,49,9,160,45,4,92,8,95,5,45,4,92,8,83
 CAGS-OP1 Sierra Donor Services,Sierra Donor Services,CAGS,2010,3430,231,74,54,166,7,32,23,72,68,635,26,,,54,166,54,14,152,47,7,87,13,92,8,47,7,87,13,84
 CAGS-OP1 Sierra Donor Services,Sierra Donor Services,CAGS,2011,3579,224,88,67,258,6,39,30,115,108,611,42,72,73,67,258,67,16,242,60,7,90,10,94,6,60,7,90,10,85
 CAGS-OP1 Sierra Donor Services,Sierra Donor Services,CAGS,2012,3353,221,86,71,257,7,39,32,116,106,608,42,74,76,71,257,71,16,241,63,8,89,11,94,6,63,8,89,11,86
 CAGS-OP1 Sierra Donor Services,Sierra Donor Services,CAGS,2013,3356,225,77,71,264,7,34,32,117,111,620,43,87,88,71,264,71,11,253,66,5,93,7,96,4,66,5,93,7,87
 CAGS-OP1 Sierra Donor Services,Sierra Donor Services,CAGS,2014,3335,235,63,68,237,7,27,29,101,91,645,37,87,89,68,237,68,25,212,56,12,82,18,89,11,56,12,82,18,88
 CAGS-OP1 Sierra Donor Services,Sierra Donor Services,CAGS,2015,3680,244,94,89,313,7,39,37,128,113,673,47,72,77,89,313,89,39,274,71,18,80,20,88,12,71,18,80,20,89
 CAGS-OP1 Sierra Donor Services,Sierra Donor Services,CAGS,2016,3820,239,95,78,277,6,40,33,116,102,657,42,66,71,78,277,78,36,241,64,14,82,18,87,13,64,14,82,18,90
 CAOP-OP1 OneLegacy,OneLegacy,CAOP,1999,23805,1333,,275,970,6,,21,73,63,3742,26,,,275,970,275,0,961,273,0,99,0,99,0,273,0,99,0,91
 CAOP-OP1 OneLegacy,OneLegacy,CAOP,2000,23680,1348,,287,988,6,,21,73,68,3751,26,,,287,988,287,5,983,285,2,99,1,99,1,285,2,99,1,92
 CAOP-OP1 OneLegacy,OneLegacy,CAOP,2001,23888,1291,,333,1133,5,,26,88,78,3598,31,,,333,1133,333,12,1121,329,4,99,1,99,1,329,4,99,1,93
 CAOP-OP1 OneLegacy,OneLegacy,CAOP,2002,23362,1296,,314,1149,6,,24,89,81,3601,32,,,314,1149,314,21,1128,307,7,98,2,98,2,307,7,98,2,94
 CAOP-OP1 OneLegacy,OneLegacy,CAOP,2003,23757,1327,,328,1174,6,,25,88,83,3673,32,,,328,1174,328,7,1167,325,3,99,1,99,1,325,3,99,1,95
 CAOP-OP1 OneLegacy,OneLegacy,CAOP,2004,22536,1325,,346,1226,6,,26,93,84,3665,33,,,346,1226,346,16,1210,339,7,98,2,99,1,339,7,98,2,96
 CAOP-OP1 OneLegacy,OneLegacy,CAOP,2005,22787,1341,,373,1348,6,,28,101,91,3690,37,,,373,1348,373,33,1315,359,14,96,4,98,2,359,14,96,4,97
 CAOP-OP1 OneLegacy,OneLegacy,CAOP,2006,22685,1389,,432,1520,6,,31,109,96,3807,40,,,432,1520,432,38,1482,416,16,96,4,98,3,416,16,96,4,98
 CAOP-OP1 OneLegacy,OneLegacy,CAOP,2007,22073,1350,,397,1390,6,,29,103,91,3702,38,,,397,1390,397,66,1324,372,25,94,6,95,5,372,25,94,6,99
 CAOP-OP1 OneLegacy,OneLegacy,CAOP,2008,21795,1288,627,400,1390,6,49,31,108,96,3537,39,,,400,1390,400,44,1346,381,19,95,5,97,3,381,19,95,5,100
 CAOP-OP1 OneLegacy,OneLegacy,CAOP,2009,21763,1317,548,382,1366,6,42,29,104,90,3618,38,,,382,1366,382,65,1301,358,24,94,6,95,5,358,24,94,6,101
 CAOP-OP1 OneLegacy,OneLegacy,CAOP,2010,20156,1269,486,349,1237,6,38,28,97,87,3479,36,,,349,1237,349,60,1177,324,25,93,7,95,5,324,25,93,7,102
 CAOP-OP1 OneLegacy,OneLegacy,CAOP,2011,20563,1276,536,417,1432,6,42,33,112,99,3501,41,71,73,417,1432,417,77,1355,384,33,92,8,95,5,384,33,92,8,103
 CAOP-OP1 OneLegacy,OneLegacy,CAOP,2012,20412,1283,503,391,1407,6,39,30,110,97,3526,40,70,72,391,1407,391,87,1320,353,38,90,10,94,6,353,38,90,10,104
 CAOP-OP1 OneLegacy,OneLegacy,CAOP,2013,20836,1327,542,422,1616,6,41,32,122,103,3629,45,69,72,422,1616,422,82,1534,384,38,91,9,95,5,384,38,91,9,105
 CAOP-OP1 OneLegacy,OneLegacy,CAOP,2014,21032,1302,528,418,1522,6,41,32,117,98,3567,43,67,71,418,1522,418,143,1379,358,60,86,14,91,9,358,60,86,14,106
 CAOP-OP1 OneLegacy,OneLegacy,CAOP,2015,22134,1375,554,460,1662,6,40,33,121,98,3784,44,70,73,460,1662,460,144,1518,400,60,87,13,91,9,400,60,87,13,107
 CAOP-OP1 OneLegacy,OneLegacy,CAOP,2016,22876,1452,558,482,1814,6,38,33,125,101,3991,45,75,77,482,1814,482,141,1673,426,56,88,12,92,8,426,56,88,12,108
 CASD-IO1 Lifesharing - A Donate Life Org.,Lifesharing - A Donate Life Org.,CASD,1999,3383,212,,70,242,6,,33,114,97,591,41,,,70,242,70,0,235,68,0,97,0,97,0,68,0,97,0,109
 CASD-IO1 Lifesharing - A Donate Life Org.,Lifesharing - A Donate Life Org.,CASD,2000,3553,214,,58,223,6,,27,104,92,593,38,,,58,223,58,0,223,58,0,100,0,100,0,58,0,100,0,110
 CASD-IO1 Lifesharing - A Donate Life Org.,Lifesharing - A Donate Life Org.,CASD,2001,3499,184,,64,224,5,,35,122,101,515,43,,,64,224,64,0,224,64,0,100,0,100,0,64,0,100,0,111
 CASD-IO1 Lifesharing - A Donate Life Org.,Lifesharing - A Donate Life Org.,CASD,2002,3250,192,,63,211,6,,33,110,98,534,40,,,63,211,63,0,211,63,0,100,0,100,0,63,0,100,0,112
 CASD-IO1 Lifesharing - A Donate Life Org.,Lifesharing - A Donate Life Org.,CASD,2003,3326,203,,68,217,6,,33,107,96,560,39,,,68,217,68,0,217,68,0,100,0,100,0,68,0,100,0,113
 CASD-IO1 Lifesharing - A Donate Life Org.,Lifesharing - A Donate Life Org.,CASD,2004,3306,217,,86,304,7,,40,140,133,595,51,,,86,304,86,7,297,83,3,97,3,98,2,83,3,97,3,114
 CASD-IO1 Lifesharing - A Donate Life Org.,Lifesharing - A Donate Life Org.,CASD,2005,3402,227,,90,298,7,,40,131,117,619,48,,,90,298,90,23,275,81,9,90,10,92,8,81,9,90,10,115
 CASD-IO1 Lifesharing - A Donate Life Org.,Lifesharing - A Donate Life Org.,CASD,2006,3213,210,,101,353,7,,48,168,147,575,61,,,101,353,101,35,318,88,13,87,13,90,10,88,13,87,13,116
 CASD-IO1 Lifesharing - A Donate Life Org.,Lifesharing - A Donate Life Org.,CASD,2007,3215,212,,95,327,7,,45,154,133,580,56,,,95,327,95,38,289,81,14,85,15,88,12,81,14,85,15,117
 CASD-IO1 Lifesharing - A Donate Life Org.,Lifesharing - A Donate Life Org.,CASD,2008,3188,223,106,99,343,7,48,44,154,137,608,56,,,99,343,99,40,303,83,16,84,16,88,12,83,16,84,16,118
 CASD-IO1 Lifesharing - A Donate Life Org.,Lifesharing - A Donate Life Org.,CASD,2009,3269,234,103,101,341,7,44,43,146,123,638,53,,,101,341,101,34,307,86,15,85,15,90,10,86,15,85,15,119
 CASD-IO1 Lifesharing - A Donate Life Org.,Lifesharing - A Donate Life Org.,CASD,2010,3019,222,110,108,381,7,50,49,172,155,605,63,,,108,381,108,31,350,94,14,87,13,92,8,94,14,87,13,120
 CASD-IO1 Lifesharing - A Donate Life Org.,Lifesharing - A Donate Life Org.,CASD,2011,3110,230,90,86,291,7,39,37,127,111,625,47,70,76,86,291,86,37,254,70,16,81,19,87,13,70,16,81,19,121
 CASD-IO1 Lifesharing - A Donate Life Org.,Lifesharing - A Donate Life Org.,CASD,2012,3062,220,82,94,302,7,37,43,137,120,603,50,73,81,94,302,94,47,255,71,23,76,24,84,16,71,23,76,24,122
 CASD-IO1 Lifesharing - A Donate Life Org.,Lifesharing - A Donate Life Org.,CASD,2013,3251,254,90,105,371,8,35,41,146,129,694,53,78,85,105,371,105,39,332,88,17,84,16,89,11,88,17,84,16,123
 CASD-IO1 Lifesharing - A Donate Life Org.,Lifesharing - A Donate Life Org.,CASD,2014,3421,276,74,103,349,8,27,37,127,111,753,46,81,88,103,349,103,75,274,72,31,70,30,79,21,72,31,70,30,124
 CASD-IO1 Lifesharing - A Donate Life Org.,Lifesharing - A Donate Life Org.,CASD,2015,3585,225,75,104,390,6,33,46,174,146,619,63,87,91,104,390,104,36,354,88,16,85,15,91,9,88,16,85,15,125
 CASD-IO1 Lifesharing - A Donate Life Org.,Lifesharing - A Donate Life Org.,CASD,2016,3596,258,85,118,431,7,33,46,167,141,707,61,82,89,118,431,118,60,371,96,22,81,19,86,14,96,22,81,19,126
 CORS-OP1 Donor Alliance,Donor Alliance,CORS,1999,5009,312,,87,312,6,,28,100,88,864,36,,,87,312,87,0,312,87,0,100,0,100,0,87,0,100,0,127
 CORS-OP1 Donor Alliance,Donor Alliance,CORS,2000,5313,328,,86,318,6,,26,97,84,908,35,,,86,318,86,0,318,86,0,100,0,100,0,86,0,100,0,128
 CORS-OP1 Donor Alliance,Donor Alliance,CORS,2001,5338,298,,72,279,6,,24,94,83,825,34,,,72,279,72,3,276,71,1,99,1,99,1,71,1,99,1,129
 CORS-OP1 Donor Alliance,Donor Alliance,CORS,2002,5223,345,,84,327,7,,24,95,87,947,35,,,84,327,84,0,327,84,0,100,0,100,0,84,0,100,0,130
 CORS-OP1 Donor Alliance,Donor Alliance,CORS,2003,5242,317,,82,301,6,,26,95,89,870,35,,,82,301,82,3,298,81,1,99,1,99,1,81,1,99,1,131
 CORS-OP1 Donor Alliance,Donor Alliance,CORS,2004,4764,344,,100,374,7,,29,109,90,938,40,,,100,374,100,4,370,98,2,98,2,99,1,98,2,98,2,132
 CORS-OP1 Donor Alliance,Donor Alliance,CORS,2005,4827,338,,125,462,7,,37,137,116,918,50,,,125,462,125,59,403,105,20,84,16,87,13,105,20,84,16,133
 CORS-OP1 Donor Alliance,Donor Alliance,CORS,2006,4893,359,,115,398,7,,32,111,96,981,41,,,115,398,115,21,377,107,8,93,7,95,5,107,8,93,7,134
 CORS-OP1 Donor Alliance,Donor Alliance,CORS,2007,4774,348,,94,369,7,,27,106,90,947,39,,,94,369,94,25,344,84,10,89,11,93,7,84,10,89,11,135
 CORS-OP1 Donor Alliance,Donor Alliance,CORS,2008,5087,378,133,115,415,7,35,30,110,94,1031,40,,,115,415,115,36,379,100,15,87,13,91,9,100,15,87,13,136
 CORS-OP1 Donor Alliance,Donor Alliance,CORS,2009,5028,363,126,115,408,7,35,32,112,101,990,41,,,115,408,115,50,358,96,19,83,17,88,12,96,19,83,17,137
 CORS-OP1 Donor Alliance,Donor Alliance,CORS,2010,4769,358,118,130,446,8,33,36,125,110,975,46,,,130,446,130,64,382,104,26,80,20,86,14,104,26,80,20,138
 CORS-OP1 Donor Alliance,Donor Alliance,CORS,2011,4767,371,122,134,500,8,33,36,135,120,1013,49,87,89,134,500,134,61,439,109,25,81,19,88,12,109,25,81,19,139
 CORS-OP1 Donor Alliance,Donor Alliance,CORS,2012,4640,372,125,126,449,8,34,34,121,105,1013,44,78,82,126,449,126,65,384,100,26,79,21,86,14,100,26,79,21,140
 CORS-OP1 Donor Alliance,Donor Alliance,CORS,2013,4993,388,139,148,523,8,36,38,135,119,1060,49,83,86,148,523,148,77,446,118,30,80,20,85,15,118,30,80,20,141
 CORS-OP1 Donor Alliance,Donor Alliance,CORS,2014,5070,390,108,109,384,8,28,28,98,86,1066,36,78,82,109,384,109,52,332,87,22,80,20,86,14,87,22,80,20,142
 CORS-OP1 Donor Alliance,Donor Alliance,CORS,2015,5140,427,118,134,483,8,28,31,113,100,1165,41,81,85,134,483,134,76,407,101,33,75,25,84,16,101,33,75,25,143
 CORS-OP1 Donor Alliance,Donor Alliance,CORS,2016,5310,462,130,139,487,9,28,30,105,92,1261,39,80,84,139,487,139,62,425,109,30,78,22,87,13,109,30,78,22,144
 CTOP-OP1 LifeChoice Donor Services,LifeChoice Donor Services,CTOP,1999,4739,226,,36,129,5,,16,57,53,638,20,,,36,129,36,5,124,34,2,94,6,96,4,34,2,94,6,145
 CTOP-OP1 LifeChoice Donor Services,LifeChoice Donor Services,CTOP,2000,4760,224,,49,173,5,,22,77,64,635,27,,,49,173,49,8,165,46,3,94,6,95,5,46,3,94,6,146
 CTOP-OP1 LifeChoice Donor Services,LifeChoice Donor Services,CTOP,2001,4607,228,,38,151,5,,17,66,62,638,24,,,38,151,38,13,138,34,4,89,11,91,9,34,4,89,11,147
 CTOP-OP1 LifeChoice Donor Services,LifeChoice Donor Services,CTOP,2002,4733,224,,45,173,5,,20,77,70,626,28,,,45,173,45,0,173,45,0,100,0,100,0,45,0,100,0,148
 CTOP-OP1 LifeChoice Donor Services,LifeChoice Donor Services,CTOP,2003,4675,205,,35,131,4,,17,64,56,570,23,,,35,131,35,3,128,34,1,97,3,98,2,34,1,97,3,149
 CTOP-OP1 LifeChoice Donor Services,LifeChoice Donor Services,CTOP,2004,4532,219,,56,216,5,,26,99,82,610,35,,,56,216,56,3,213,55,1,98,2,99,1,55,1,98,2,150
 CTOP-OP1 LifeChoice Donor Services,LifeChoice Donor Services,CTOP,2005,4649,212,,45,161,5,,21,76,66,592,27,,,45,161,45,13,148,40,5,89,11,92,8,40,5,89,11,151
 CTOP-OP1 LifeChoice Donor Services,LifeChoice Donor Services,CTOP,2006,4515,222,,43,167,5,,19,75,63,614,27,,,43,167,43,4,163,42,1,98,2,98,2,42,1,98,2,152
 CTOP-OP1 LifeChoice Donor Services,LifeChoice Donor Services,CTOP,2007,4430,204,,34,127,5,,17,62,52,571,22,,,34,127,34,12,115,31,3,91,9,91,9,31,3,91,9,153
 CTOP-OP1 LifeChoice Donor Services,LifeChoice Donor Services,CTOP,2008,4414,217,55,41,146,5,25,19,67,62,600,24,,,41,146,41,11,135,37,4,90,10,92,8,37,4,90,10,154
 CTOP-OP1 LifeChoice Donor Services,LifeChoice Donor Services,CTOP,2009,4448,224,48,36,138,5,21,16,62,55,622,22,,,36,138,36,22,116,29,7,81,19,84,16,29,7,81,19,155
 CTOP-OP1 LifeChoice Donor Services,LifeChoice Donor Services,CTOP,2010,4340,214,47,47,174,5,22,22,81,71,593,29,,,47,174,47,16,158,41,6,87,13,91,9,41,6,87,13,156
 CTOP-OP1 LifeChoice Donor Services,LifeChoice Donor Services,CTOP,2011,4456,234,44,34,126,5,19,15,54,49,649,19,66,69,34,126,34,7,119,31,3,91,9,94,6,31,3,91,9,157
 CTOP-OP1 LifeChoice Donor Services,LifeChoice Donor Services,CTOP,2012,4308,218,52,42,156,5,24,19,71,63,602,26,71,74,42,156,42,10,146,38,4,90,10,94,6,38,4,90,10,158
 CTOP-OP1 LifeChoice Donor Services,LifeChoice Donor Services,CTOP,2013,4405,248,42,32,100,6,17,13,40,35,691,14,57,64,32,100,32,16,84,25,7,78,22,84,16,25,7,78,22,159
 CTOP-OP1 LifeChoice Donor Services,LifeChoice Donor Services,CTOP,2014,4422,228,52,43,137,5,23,19,60,52,629,22,67,72,43,137,43,13,124,38,5,88,12,91,9,38,5,88,12,160
 CTOP-OP1 LifeChoice Donor Services,LifeChoice Donor Services,CTOP,2015,4599,261,48,39,144,6,18,15,55,49,722,20,69,72,39,144,39,9,135,35,4,90,10,94,6,35,4,90,10,161
 CTOP-OP1 LifeChoice Donor Services,LifeChoice Donor Services,CTOP,2016,4602,271,45,39,127,6,17,14,47,43,748,17,69,74,39,127,39,18,109,31,8,79,21,86,14,31,8,79,21,162
 DCTC-OP1 Washington Reg Transplant Community,Washington Reg Transplant Community,DCTC,1999,5938,274,,90,335,5,,33,122,98,760,44,,,90,335,90,18,317,83,7,92,8,95,5,83,7,92,8,163
 DCTC-OP1 Washington Reg Transplant Community,Washington Reg Transplant Community,DCTC,2000,5995,295,,82,308,5,,28,104,88,814,38,,,82,308,82,12,296,78,4,95,5,96,4,78,4,95,5,164
 DCTC-OP1 Washington Reg Transplant Community,Washington Reg Transplant Community,DCTC,2001,5870,283,,78,304,5,,28,108,97,780,39,,,78,304,78,3,301,77,1,99,1,99,1,77,1,99,1,165
 DCTC-OP1 Washington Reg Transplant Community,Washington Reg Transplant Community,DCTC,2002,5869,284,,87,346,5,,31,122,108,789,44,,,87,346,87,8,338,84,3,97,3,98,2,84,3,97,3,166
 DCTC-OP1 Washington Reg Transplant Community,Washington Reg Transplant Community,DCTC,2003,6091,312,,86,314,5,,28,101,89,849,37,,,86,314,86,13,301,81,5,94,6,96,4,81,5,94,6,167
 DCTC-OP1 Washington Reg Transplant Community,Washington Reg Transplant Community,DCTC,2004,5931,297,,120,415,5,,40,140,105,820,51,,,120,415,120,34,381,108,12,90,10,92,8,108,12,90,10,168
 DCTC-OP1 Washington Reg Transplant Community,Washington Reg Transplant Community,DCTC,2005,5881,320,,151,498,5,,47,156,118,878,57,,,151,498,151,63,435,129,22,85,15,87,13,129,22,85,15,169
 DCTC-OP1 Washington Reg Transplant Community,Washington Reg Transplant Community,DCTC,2006,5996,309,,126,448,5,,41,145,118,847,53,,,126,448,126,52,396,110,16,87,13,88,12,110,16,87,13,170
 DCTC-OP1 Washington Reg Transplant Community,Washington Reg Transplant Community,DCTC,2007,6115,299,,108,368,5,,36,123,99,821,45,,,108,368,108,32,336,98,10,91,9,91,9,98,10,91,9,171
 DCTC-OP1 Washington Reg Transplant Community,Washington Reg Transplant Community,DCTC,2008,5964,315,119,119,413,5,38,38,131,107,867,48,,,119,413,119,45,368,104,15,87,13,89,11,104,15,87,13,172
 DCTC-OP1 Washington Reg Transplant Community,Washington Reg Transplant Community,DCTC,2009,5800,311,127,128,467,5,41,41,150,127,855,55,,,128,467,128,50,417,109,19,85,15,89,11,109,19,85,15,173
 DCTC-OP1 Washington Reg Transplant Community,Washington Reg Transplant Community,DCTC,2010,5912,384,125,115,412,6,33,30,107,91,1046,39,,,115,412,115,63,349,92,23,80,20,85,15,92,23,80,20,174
 DCTC-OP1 Washington Reg Transplant Community,Washington Reg Transplant Community,DCTC,2011,5551,368,135,128,421,7,37,35,114,93,1003,42,66,74,128,421,128,76,345,99,29,77,23,82,18,99,29,77,23,175
 DCTC-OP1 Washington Reg Transplant Community,Washington Reg Transplant Community,DCTC,2012,5426,325,136,132,421,6,42,41,130,111,894,47,58,70,132,421,132,72,349,103,29,78,22,83,17,103,29,78,22,176
 DCTC-OP1 Washington Reg Transplant Community,Washington Reg Transplant Community,DCTC,2013,5408,299,149,126,443,6,50,42,148,129,820,54,62,69,126,443,126,58,385,103,23,82,18,87,13,103,23,82,18,177
 DCTC-OP1 Washington Reg Transplant Community,Washington Reg Transplant Community,DCTC,2014,5535,318,149,141,457,6,47,44,144,114,873,52,64,72,141,457,141,91,366,106,35,75,25,80,20,106,35,75,25,178
 DCTC-OP1 Washington Reg Transplant Community,Washington Reg Transplant Community,DCTC,2015,5459,320,141,143,458,6,44,45,143,122,881,52,68,76,143,458,143,79,379,109,34,76,24,83,17,109,34,76,24,179
 DCTC-OP1 Washington Reg Transplant Community,Washington Reg Transplant Community,DCTC,2016,5698,361,156,135,487,6,43,37,135,113,994,49,71,75,135,487,135,41,446,120,15,89,11,92,8,120,15,89,11,180
 FLFH-IO1 TransLife,TransLife,FLFH,1999,4889,246,,78,247,5,,32,101,92,692,36,,,78,247,78,2,245,77,1,99,1,99,1,77,1,99,1,181
 FLFH-IO1 TransLife,TransLife,FLFH,2000,4860,278,,93,303,6,,33,109,97,778,39,,,93,303,93,17,286,87,6,94,6,94,6,87,6,94,6,182
 FLFH-IO1 TransLife,TransLife,FLFH,2001,4856,273,,96,291,6,,35,106,91,765,38,,,96,291,96,34,257,82,14,85,15,88,12,82,14,85,15,183
 FLFH-IO1 TransLife,TransLife,FLFH,2002,4920,273,,82,250,6,,30,91,78,761,33,,,82,250,82,16,234,75,7,91,9,94,6,75,7,91,9,184
 FLFH-IO1 TransLife,TransLife,FLFH,2003,4960,263,,86,289,5,,33,110,98,735,39,,,86,289,86,19,270,78,8,91,9,93,7,78,8,91,9,185
 FLFH-IO1 TransLife,TransLife,FLFH,2004,5129,299,,105,371,6,,35,124,114,825,45,,,105,371,105,9,362,101,4,96,4,98,2,101,4,96,4,186
 FLFH-IO1 TransLife,TransLife,FLFH,2005,4982,307,,91,335,6,,30,109,96,846,40,,,91,335,91,28,307,80,11,88,12,92,8,80,11,88,12,187
 FLFH-IO1 TransLife,TransLife,FLFH,2006,4777,303,,83,275,6,,27,91,85,831,33,,,83,275,83,44,231,67,16,81,19,84,16,67,16,81,19,188
 FLFH-IO1 TransLife,TransLife,FLFH,2007,4587,283,,104,338,6,,37,119,108,779,43,,,104,338,104,45,293,86,18,83,17,87,13,86,18,83,17,189
 FLFH-IO1 TransLife,TransLife,FLFH,2008,4554,274,126,99,371,6,46,36,135,121,753,49,,,99,371,99,27,344,89,10,90,10,93,7,89,10,90,10,190
 FLFH-IO1 TransLife,TransLife,FLFH,2009,4479,291,122,104,382,6,42,36,131,122,799,48,,,104,382,104,35,347,91,13,88,13,91,9,91,13,88,13,191
 FLFH-IO1 TransLife,TransLife,FLFH,2010,4602,307,120,102,380,7,39,33,124,112,847,45,,,102,380,102,27,353,92,10,90,10,93,7,92,10,90,10,192
 FLFH-IO1 TransLife,TransLife,FLFH,2011,4598,313,108,91,333,7,35,29,107,100,861,39,73,76,91,333,91,27,306,79,12,87,13,92,8,79,12,87,13,193
 FLFH-IO1 TransLife,TransLife,FLFH,2012,4634,308,111,110,417,7,36,36,135,125,845,49,82,85,110,417,110,45,372,92,18,84,16,89,11,92,18,84,16,194
 FLFH-IO1 TransLife,TransLife,FLFH,2013,4749,286,96,91,329,6,34,32,115,112,794,41,70,76,91,329,91,60,269,68,23,75,25,82,18,68,23,75,25,195
 FLFH-IO1 TransLife,TransLife,FLFH,2014,4927,312,84,78,255,6,27,25,82,76,857,30,76,80,78,255,78,38,217,61,17,78,22,85,15,61,17,78,22,196
 FLFH-IO1 TransLife,TransLife,FLFH,2015,5135,329,137,124,380,6,42,38,116,100,907,42,67,73,124,380,124,63,317,94,30,76,24,83,17,94,30,76,24,197
 FLFH-IO1 TransLife,TransLife,FLFH,2016,5261,360,171,163,556,7,48,45,154,138,988,56,75,79,163,556,163,75,481,129,34,79,21,87,13,129,34,79,21,198
 FLMP-OP1 Life Alliance Organ Recovery Agency,Life Alliance Organ Recovery Agency,FLMP,1999,11257,508,,125,425,5,,25,84,67,1428,30,,,125,425,125,14,411,120,5,96,4,97,3,120,5,96,4,199
 FLMP-OP1 Life Alliance Organ Recovery Agency,Life Alliance Organ Recovery Agency,FLMP,2000,10609,487,,105,348,5,,22,71,60,1366,25,,,105,348,105,6,342,103,2,98,2,98,2,103,2,98,2,200
 FLMP-OP1 Life Alliance Organ Recovery Agency,Life Alliance Organ Recovery Agency,FLMP,2001,10704,499,,126,479,5,,25,96,80,1393,34,,,126,479,126,20,459,118,8,94,6,96,4,118,8,94,6,201
 FLMP-OP1 Life Alliance Organ Recovery Agency,Life Alliance Organ Recovery Agency,FLMP,2002,10420,496,,115,398,5,,23,80,69,1385,29,,,115,398,115,2,396,114,1,99,1,99,1,114,1,99,1,202
 FLMP-OP1 Life Alliance Organ Recovery Agency,Life Alliance Organ Recovery Agency,FLMP,2003,10299,480,,114,402,5,,24,84,70,1345,30,,,114,402,114,17,385,108,6,95,5,96,4,108,6,95,5,203
 FLMP-OP1 Life Alliance Organ Recovery Agency,Life Alliance Organ Recovery Agency,FLMP,2004,10092,485,,125,422,5,,26,87,75,1350,31,,,125,422,125,6,416,123,2,98,2,99,1,123,2,98,2,204
 FLMP-OP1 Life Alliance Organ Recovery Agency,Life Alliance Organ Recovery Agency,FLMP,2005,9783,483,,113,452,5,,23,94,87,1345,34,,,113,452,113,13,439,108,5,96,4,97,3,108,5,96,4,205
 FLMP-OP1 Life Alliance Organ Recovery Agency,Life Alliance Organ Recovery Agency,FLMP,2006,9333,499,,126,467,5,,25,94,85,1376,34,,,126,467,126,8,459,123,3,98,2,98,2,123,3,98,2,206
 FLMP-OP1 Life Alliance Organ Recovery Agency,Life Alliance Organ Recovery Agency,FLMP,2007,8887,502,,144,539,6,,29,107,101,1379,39,,,144,539,144,14,525,139,5,97,3,97,3,139,5,97,3,207
 FLMP-OP1 Life Alliance Organ Recovery Agency,Life Alliance Organ Recovery Agency,FLMP,2008,8569,465,176,134,477,5,38,29,102,87,1288,37,,,134,477,134,26,451,125,9,93,7,95,5,125,9,93,7,208
 FLMP-OP1 Life Alliance Organ Recovery Agency,Life Alliance Organ Recovery Agency,FLMP,2009,8432,486,164,124,457,6,34,26,94,81,1338,34,,,124,457,124,22,435,116,8,94,6,95,5,116,8,94,6,209
 FLMP-OP1 Life Alliance Organ Recovery Agency,Life Alliance Organ Recovery Agency,FLMP,2010,8030,480,192,142,502,6,40,30,105,93,1323,38,,,142,502,142,12,490,137,5,96,4,98,2,137,5,96,4,210
 FLMP-OP1 Life Alliance Organ Recovery Agency,Life Alliance Organ Recovery Agency,FLMP,2011,7905,503,170,142,531,6,34,28,106,95,1387,38,74,76,142,531,142,19,512,134,8,94,6,96,4,134,8,94,6,211
 FLMP-OP1 Life Alliance Organ Recovery Agency,Life Alliance Organ Recovery Agency,FLMP,2012,7731,466,191,145,516,6,41,31,111,97,1283,40,71,72,145,516,145,13,503,139,6,96,4,97,3,139,6,96,4,212
 FLMP-OP1 Life Alliance Organ Recovery Agency,Life Alliance Organ Recovery Agency,FLMP,2013,7435,434,184,140,493,6,42,32,114,103,1194,41,69,71,140,493,140,10,483,136,4,97,3,98,2,136,4,97,3,213
 FLMP-OP1 Life Alliance Organ Recovery Agency,Life Alliance Organ Recovery Agency,FLMP,2014,7689,471,196,162,560,6,42,34,119,106,1296,43,70,74,162,560,162,31,529,150,12,93,7,94,6,150,12,93,7,214
 FLMP-OP1 Life Alliance Organ Recovery Agency,Life Alliance Organ Recovery Agency,FLMP,2015,7932,521,180,158,550,7,35,30,105,99,1430,38,75,78,158,550,158,48,502,138,20,87,13,91,9,138,20,87,13,215
 FLMP-OP1 Life Alliance Organ Recovery Agency,Life Alliance Organ Recovery Agency,FLMP,2016,8288,544,198,163,569,7,36,30,105,90,1495,38,64,69,163,569,163,60,509,138,25,85,15,89,11,138,25,85,15,216
 FLUF-IO1 LifeQuest Organ Recovery Services,LifeQuest Organ Recovery Services,FLUF,1999,6619,345,,90,274,5,,26,79,66,972,28,,,90,274,90,17,257,84,6,93,7,94,6,84,6,93,7,217
 FLUF-IO1 LifeQuest Organ Recovery Services,LifeQuest Organ Recovery Services,FLUF,2000,6563,367,,101,304,6,,28,83,68,1025,30,,,101,304,101,24,280,90,11,89,11,92,8,90,11,89,11,218
 FLUF-IO1 LifeQuest Organ Recovery Services,LifeQuest Organ Recovery Services,FLUF,2001,6460,361,,103,360,6,,29,100,90,1013,36,,,103,360,103,28,332,92,11,89,11,92,8,92,11,89,11,219
 FLUF-IO1 LifeQuest Organ Recovery Services,LifeQuest Organ Recovery Services,FLUF,2002,6466,371,,103,335,6,,28,90,82,1030,33,,,103,335,103,33,302,90,13,87,13,90,10,90,13,87,13,220
 FLUF-IO1 LifeQuest Organ Recovery Services,LifeQuest Organ Recovery Services,FLUF,2003,6438,359,,109,372,6,,30,104,92,996,37,,,109,372,109,35,337,98,11,90,10,91,9,98,11,90,10,221
 FLUF-IO1 LifeQuest Organ Recovery Services,LifeQuest Organ Recovery Services,FLUF,2004,6383,363,,108,406,6,,30,112,99,1006,40,,,108,406,108,49,357,90,18,83,17,88,12,90,18,83,17,222
 FLUF-IO1 LifeQuest Organ Recovery Services,LifeQuest Organ Recovery Services,FLUF,2005,5982,384,,126,437,6,,33,114,97,1058,41,,,126,437,126,70,367,101,25,80,20,84,16,101,25,80,20,223
 FLUF-IO1 LifeQuest Organ Recovery Services,LifeQuest Organ Recovery Services,FLUF,2006,6046,361,,125,405,6,,35,112,95,993,41,,,125,405,125,61,344,102,23,82,18,85,15,102,23,82,18,224
 FLUF-IO1 LifeQuest Organ Recovery Services,LifeQuest Organ Recovery Services,FLUF,2007,5843,394,,132,428,7,,34,109,92,1083,40,,,132,428,132,117,311,90,42,68,32,73,27,90,42,68,32,225
 FLUF-IO1 LifeQuest Organ Recovery Services,LifeQuest Organ Recovery Services,FLUF,2008,6011,376,106,129,433,6,28,34,115,98,1033,42,,,129,433,129,73,360,102,27,79,21,83,17,102,27,79,21,226
 FLUF-IO1 LifeQuest Organ Recovery Services,LifeQuest Organ Recovery Services,FLUF,2009,5931,388,127,109,386,7,33,28,100,87,1062,36,,,109,386,109,43,343,92,17,84,16,89,11,92,17,84,16,227
 FLUF-IO1 LifeQuest Organ Recovery Services,LifeQuest Organ Recovery Services,FLUF,2010,5823,403,121,135,461,7,30,34,114,96,1104,42,,,135,461,135,70,391,110,25,81,19,85,15,110,25,81,19,228
 FLUF-IO1 LifeQuest Organ Recovery Services,LifeQuest Organ Recovery Services,FLUF,2011,5907,399,142,141,525,7,36,35,132,113,1091,48,74,79,141,525,141,58,467,120,21,85,15,89,11,120,21,85,15,229
 FLUF-IO1 LifeQuest Organ Recovery Services,LifeQuest Organ Recovery Services,FLUF,2012,5601,356,149,130,473,6,42,37,133,117,980,48,72,76,130,473,130,39,434,116,14,89,11,92,8,116,14,89,11,230
 FLUF-IO1 LifeQuest Organ Recovery Services,LifeQuest Organ Recovery Services,FLUF,2013,5882,383,137,126,466,7,36,33,122,109,1052,44,70,75,126,466,126,63,403,101,25,80,20,86,14,101,25,80,20,231
 FLUF-IO1 LifeQuest Organ Recovery Services,LifeQuest Organ Recovery Services,FLUF,2014,5969,370,142,142,466,6,38,38,126,109,1014,46,72,78,142,466,142,66,400,115,27,81,19,86,14,115,27,81,19,232
 FLUF-IO1 LifeQuest Organ Recovery Services,LifeQuest Organ Recovery Services,FLUF,2015,6058,377,155,148,501,6,41,39,133,115,1036,48,68,75,148,501,148,81,420,120,28,81,19,84,16,120,28,81,19,233
 FLUF-IO1 LifeQuest Organ Recovery Services,LifeQuest Organ Recovery Services,FLUF,2016,6246,419,186,160,596,7,44,38,142,123,1151,52,70,74,160,596,160,67,529,139,21,87,13,89,11,139,21,87,13,234
 FLWC-OP1 LifeLink of Florida,LifeLink of Florida,FLWC,1999,8548,460,,144,468,5,,31,102,95,1302,36,,,144,468,144,0,468,144,0,100,0,100,0,144,0,100,0,235
 FLWC-OP1 LifeLink of Florida,LifeLink of Florida,FLWC,2000,8538,481,,137,434,6,,28,90,83,1357,32,,,137,434,137,2,432,136,1,99,1,100,0,136,1,99,1,236
 FLWC-OP1 LifeLink of Florida,LifeLink of Florida,FLWC,2001,8565,436,,138,456,5,,32,105,96,1219,37,,,138,456,138,2,451,136,1,99,1,99,0,136,1,99,1,237
 FLWC-OP1 LifeLink of Florida,LifeLink of Florida,FLWC,2002,8278,439,,139,438,5,,32,100,94,1230,36,,,139,438,139,0,438,139,0,100,0,100,0,139,0,100,0,238
 FLWC-OP1 LifeLink of Florida,LifeLink of Florida,FLWC,2003,8202,474,,135,447,6,,28,94,87,1313,34,,,135,447,135,0,447,135,0,100,0,100,0,135,0,100,0,239
 FLWC-OP1 LifeLink of Florida,LifeLink of Florida,FLWC,2004,8271,504,,137,434,6,,27,86,76,1396,31,,,137,434,137,0,434,137,0,100,0,100,0,137,0,100,0,240
 FLWC-OP1 LifeLink of Florida,LifeLink of Florida,FLWC,2005,7830,489,,138,428,6,,28,88,79,1347,32,,,138,428,138,2,426,137,1,99,1,100,0,137,1,99,1,241
 FLWC-OP1 LifeLink of Florida,LifeLink of Florida,FLWC,2006,7755,461,,170,564,6,,37,122,109,1275,44,,,170,564,170,3,561,169,1,99,1,99,1,169,1,99,1,242
 FLWC-OP1 LifeLink of Florida,LifeLink of Florida,FLWC,2007,7393,499,,174,592,7,,35,119,110,1369,43,,,174,592,174,8,584,170,4,98,2,99,1,170,4,98,2,243
 FLWC-OP1 LifeLink of Florida,LifeLink of Florida,FLWC,2008,7262,480,200,180,603,7,42,38,126,114,1315,46,,,180,603,180,15,588,174,6,97,3,98,2,174,6,97,3,244
 FLWC-OP1 LifeLink of Florida,LifeLink of Florida,FLWC,2009,7414,491,189,175,548,7,38,36,112,101,1352,41,,,175,548,175,12,536,170,5,97,3,98,2,170,5,97,3,245
 FLWC-OP1 LifeLink of Florida,LifeLink of Florida,FLWC,2010,7293,497,165,167,553,7,33,34,111,103,1368,40,,,167,553,167,31,522,154,13,92,8,94,6,154,13,92,8,246
 FLWC-OP1 LifeLink of Florida,LifeLink of Florida,FLWC,2011,7230,492,156,195,648,7,32,40,132,120,1355,48,89,92,195,648,195,48,600,175,20,90,10,93,7,175,20,90,10,247
 FLWC-OP1 LifeLink of Florida,LifeLink of Florida,FLWC,2012,7214,484,190,169,551,7,39,35,114,103,1329,41,72,76,169,551,169,49,502,150,19,89,11,91,9,150,19,89,11,248
 FLWC-OP1 LifeLink of Florida,LifeLink of Florida,FLWC,2013,7559,468,176,177,607,6,38,38,130,116,1291,47,78,82,177,607,177,47,560,160,17,90,10,92,8,160,17,90,10,249
 FLWC-OP1 LifeLink of Florida,LifeLink of Florida,FLWC,2014,7970,490,199,190,624,6,41,39,127,120,1349,46,78,81,190,624,190,28,596,178,12,94,6,96,4,178,12,94,6,250
 FLWC-OP1 LifeLink of Florida,LifeLink of Florida,FLWC,2015,8126,525,224,207,698,6,43,39,133,122,1450,48,77,80,207,698,207,40,658,192,15,93,7,94,6,192,15,93,7,251
 FLWC-OP1 LifeLink of Florida,LifeLink of Florida,FLWC,2016,8455,567,238,230,737,7,42,41,130,117,1554,47,80,83,230,737,230,60,677,206,24,90,10,92,8,206,24,90,10,252
 GALL-OP1 LifeLink of Georgia,LifeLink of Georgia,GALL,1999,14718,869,,184,650,6,,21,75,70,2418,27,,,184,650,184,0,648,183,0,99,0,100,0,183,0,99,0,253
 GALL-OP1 LifeLink of Georgia,LifeLink of Georgia,GALL,2000,14672,854,,171,553,6,,20,65,59,2370,23,,,171,553,171,0,553,171,0,100,0,100,0,171,0,100,0,254
 GALL-OP1 LifeLink of Georgia,LifeLink of Georgia,GALL,2001,14784,881,,205,714,6,,23,81,74,2424,29,,,205,714,205,0,714,205,0,100,0,100,0,205,0,100,0,255
 GALL-OP1 LifeLink of Georgia,LifeLink of Georgia,GALL,2002,14561,817,,182,615,6,,22,75,69,2253,27,,,182,615,182,2,613,181,1,99,1,100,0,181,1,99,1,256
 GALL-OP1 LifeLink of Georgia,LifeLink of Georgia,GALL,2003,14814,828,,197,680,6,,24,82,74,2288,30,,,197,680,197,0,680,197,0,100,0,100,0,197,0,100,0,257
 GALL-OP1 LifeLink of Georgia,LifeLink of Georgia,GALL,2004,14304,829,,238,787,6,,29,95,84,2282,34,,,238,787,238,0,787,238,0,100,0,100,0,238,0,100,0,258
 GALL-OP1 LifeLink of Georgia,LifeLink of Georgia,GALL,2005,14242,858,,231,776,6,,27,90,79,2348,33,,,231,776,231,3,773,230,1,100,0,100,0,230,1,100,0,259
 GALL-OP1 LifeLink of Georgia,LifeLink of Georgia,GALL,2006,15071,970,,267,902,6,,28,93,82,2654,34,,,267,902,267,9,893,264,3,99,1,99,1,264,3,99,1,260
 GALL-OP1 LifeLink of Georgia,LifeLink of Georgia,GALL,2007,13887,917,,244,849,7,,27,93,82,2506,34,,,244,849,244,6,843,242,2,99,1,99,1,242,2,99,1,261
 GALL-OP1 LifeLink of Georgia,LifeLink of Georgia,GALL,2008,8109,449,333,259,862,6,74,58,192,170,1232,70,,,259,862,259,6,856,257,2,99,1,99,1,257,2,99,1,262
 GALL-OP1 LifeLink of Georgia,LifeLink of Georgia,GALL,2009,829,77,324,252,884,9,422,328,1151,967,206,428,,,252,884,252,16,868,246,6,98,2,98,2,246,6,98,2,263
 GALL-OP1 LifeLink of Georgia,LifeLink of Georgia,GALL,2010,13958,937,341,284,975,7,36,30,104,92,2571,38,,,284,975,284,12,963,279,5,98,2,99,1,279,5,98,2,264
 GALL-OP1 LifeLink of Georgia,LifeLink of Georgia,GALL,2011,13024,846,282,254,842,6,33,30,99,85,2311,36,74,77,254,842,254,12,830,249,5,98,2,99,1,249,5,98,2,265
 GALL-OP1 LifeLink of Georgia,LifeLink of Georgia,GALL,2012,13150,873,353,269,922,7,40,31,106,94,2401,38,69,71,269,922,269,12,910,264,5,98,2,99,1,264,5,98,2,266
 GALL-OP1 LifeLink of Georgia,LifeLink of Georgia,GALL,2013,13948,895,339,269,917,6,38,30,102,93,2447,37,74,76,269,917,269,8,909,266,3,99,1,99,1,266,3,99,1,267
 GALL-OP1 LifeLink of Georgia,LifeLink of Georgia,GALL,2014,13902,876,353,268,938,6,40,31,107,100,2401,39,70,72,268,938,268,18,920,262,6,98,2,98,2,262,6,98,2,268
 GALL-OP1 LifeLink of Georgia,LifeLink of Georgia,GALL,2015,14276,936,369,274,939,7,39,29,100,93,2562,37,69,71,274,939,274,31,908,264,10,96,4,97,3,264,10,96,4,269
 GALL-OP1 LifeLink of Georgia,LifeLink of Georgia,GALL,2016,14837,943,377,306,1018,6,40,32,108,97,2595,39,76,77,306,1018,306,14,1004,300,6,98,2,99,1,300,6,98,2,270
 HIOP-OP1 Legacy of Life Hawaii,Legacy of Life Hawaii,HIOP,1999,1932,131,,25,78,7,,19,59,54,371,21,,,25,78,25,0,76,24,0,96,0,97,0,24,0,96,0,271
 HIOP-OP1 Legacy of Life Hawaii,Legacy of Life Hawaii,HIOP,2000,1852,123,,29,85,7,,24,69,57,344,25,,,29,85,29,0,85,29,0,100,0,100,0,29,0,100,0,272
 HIOP-OP1 Legacy of Life Hawaii,Legacy of Life Hawaii,HIOP,2001,1802,108,,26,75,6,,24,69,60,304,25,,,26,75,26,0,75,26,0,100,0,100,0,26,0,100,0,273
 HIOP-OP1 Legacy of Life Hawaii,Legacy of Life Hawaii,HIOP,2002,1863,112,,25,80,6,,22,71,67,314,25,,,25,80,25,0,80,25,0,100,0,100,0,25,0,100,0,274
 HIOP-OP1 Legacy of Life Hawaii,Legacy of Life Hawaii,HIOP,2003,1813,104,,29,82,6,,28,79,68,286,29,,,29,82,29,0,82,29,0,100,0,100,0,29,0,100,0,275
 HIOP-OP1 Legacy of Life Hawaii,Legacy of Life Hawaii,HIOP,2004,1824,103,,24,65,6,,23,63,56,285,23,,,24,65,24,2,63,23,1,96,4,97,3,23,1,96,4,276
 HIOP-OP1 Legacy of Life Hawaii,Legacy of Life Hawaii,HIOP,2005,1919,119,,25,74,6,,21,62,55,326,23,,,25,74,25,3,71,24,1,96,4,96,4,24,1,96,4,277
 HIOP-OP1 Legacy of Life Hawaii,Legacy of Life Hawaii,HIOP,2006,1920,120,,26,82,6,,22,68,59,334,25,,,26,82,26,4,78,24,2,92,8,95,5,24,2,92,8,278
 HIOP-OP1 Legacy of Life Hawaii,Legacy of Life Hawaii,HIOP,2007,1864,116,,21,59,6,,18,51,46,319,18,,,21,59,21,4,55,19,2,90,10,93,7,19,2,90,10,279
 HIOP-OP1 Legacy of Life Hawaii,Legacy of Life Hawaii,HIOP,2008,1803,113,70,37,110,6,62,33,97,84,313,35,,,37,110,37,4,106,35,2,95,5,96,4,35,2,95,5,280
 HIOP-OP1 Legacy of Life Hawaii,Legacy of Life Hawaii,HIOP,2009,1777,124,62,31,89,7,50,25,72,61,341,26,,,31,89,31,0,89,31,0,100,0,100,0,31,0,100,0,281
 HIOP-OP1 Legacy of Life Hawaii,Legacy of Life Hawaii,HIOP,2010,1692,127,61,34,101,7,48,27,80,71,347,29,,,34,101,34,2,99,33,1,97,3,98,2,33,1,97,3,282
 HIOP-OP1 Legacy of Life Hawaii,Legacy of Life Hawaii,HIOP,2011,1732,139,65,47,137,8,47,34,98,77,380,36,62,65,47,137,47,10,127,42,5,89,11,93,7,42,5,89,11,283
 HIOP-OP1 Legacy of Life Hawaii,Legacy of Life Hawaii,HIOP,2012,1688,134,75,57,156,8,56,43,116,87,367,42,63,67,57,156,57,20,136,47,10,82,18,87,13,47,10,82,18,284
 HIOP-OP1 Legacy of Life Hawaii,Legacy of Life Hawaii,HIOP,2013,1704,125,61,41,116,7,49,33,93,67,346,33,54,59,41,116,41,10,106,36,5,88,12,91,9,36,5,88,12,285
 HIOP-OP1 Legacy of Life Hawaii,Legacy of Life Hawaii,HIOP,2014,1682,131,55,47,133,8,42,36,102,90,360,37,76,78,47,133,47,12,121,41,6,87,13,91,9,41,6,87,13,286
 HIOP-OP1 Legacy of Life Hawaii,Legacy of Life Hawaii,HIOP,2015,1687,139,46,40,129,8,33,29,93,77,381,34,67,73,40,129,40,16,113,32,8,80,20,88,12,32,8,80,20,287
 HIOP-OP1 Legacy of Life Hawaii,Legacy of Life Hawaii,HIOP,2016,1661,146,45,39,113,9,31,27,77,69,397,28,67,72,39,113,39,19,94,30,9,77,23,83,17,30,9,77,23,288
 IAOP-OP1 Iowa Donor Network,Iowa Donor Network,IAOP,1999,4451,211,,52,216,5,,25,103,91,601,36,,,52,216,52,0,216,52,0,100,0,100,0,52,0,100,0,289
 IAOP-OP1 Iowa Donor Network,Iowa Donor Network,IAOP,2000,4447,204,,60,215,5,,29,106,88,578,37,,,60,215,60,0,215,60,0,100,0,100,0,60,0,100,0,290
 IAOP-OP1 Iowa Donor Network,Iowa Donor Network,IAOP,2001,4250,215,,55,229,5,,26,107,92,609,38,,,55,229,55,6,223,53,2,96,4,97,3,53,2,96,4,291
 IAOP-OP1 Iowa Donor Network,Iowa Donor Network,IAOP,2002,3969,205,,51,193,5,,25,94,86,579,33,,,51,193,51,18,175,45,6,88,12,91,9,45,6,88,12,292
 IAOP-OP1 Iowa Donor Network,Iowa Donor Network,IAOP,2003,3945,190,,47,204,5,,25,107,96,532,38,,,47,204,47,10,194,44,3,94,6,95,5,44,3,94,6,293
 IAOP-OP1 Iowa Donor Network,Iowa Donor Network,IAOP,2004,3594,184,,39,144,5,,21,78,62,517,28,,,39,144,39,20,124,33,6,85,15,86,14,33,6,85,15,294
 IAOP-OP1 Iowa Donor Network,Iowa Donor Network,IAOP,2005,3709,212,,52,204,6,,25,96,84,588,35,,,52,204,52,6,198,50,2,96,4,97,3,50,2,96,4,295
 IAOP-OP1 Iowa Donor Network,Iowa Donor Network,IAOP,2006,3491,194,,45,181,6,,23,93,80,538,34,,,45,181,45,13,168,41,4,91,9,93,7,41,4,91,9,296
 IAOP-OP1 Iowa Donor Network,Iowa Donor Network,IAOP,2007,3545,202,,55,201,6,,27,99,87,560,36,,,55,201,55,19,182,48,7,87,13,91,9,48,7,87,13,297
 IAOP-OP1 Iowa Donor Network,Iowa Donor Network,IAOP,2008,3571,215,57,52,202,6,27,24,94,84,594,34,,,52,202,52,15,187,46,6,88,12,93,7,46,6,88,12,298
 IAOP-OP1 Iowa Donor Network,Iowa Donor Network,IAOP,2009,3405,208,57,55,214,6,27,26,103,92,583,37,,,55,214,55,11,203,51,4,93,7,95,5,51,4,93,7,299
 IAOP-OP1 Iowa Donor Network,Iowa Donor Network,IAOP,2010,3327,216,71,66,264,6,33,31,122,113,597,44,,,66,264,66,21,243,58,8,88,12,92,8,58,8,88,12,300
 IAOP-OP1 Iowa Donor Network,Iowa Donor Network,IAOP,2011,3334,213,48,50,185,6,23,23,87,82,586,32,83,86,50,185,50,28,157,40,10,80,20,85,15,40,10,80,20,301
 IAOP-OP1 Iowa Donor Network,Iowa Donor Network,IAOP,2012,3299,199,56,60,213,6,28,30,107,95,548,39,82,86,60,213,60,26,187,48,12,80,20,88,12,48,12,80,20,302
 IAOP-OP1 Iowa Donor Network,Iowa Donor Network,IAOP,2013,3370,215,55,67,239,6,26,31,111,95,592,40,85,89,67,239,67,35,204,51,16,76,24,85,15,51,16,76,24,303
 IAOP-OP1 Iowa Donor Network,Iowa Donor Network,IAOP,2014,3501,220,59,60,216,6,27,27,98,89,605,36,92,92,60,216,60,13,203,54,6,90,10,94,6,54,6,90,10,304
 IAOP-OP1 Iowa Donor Network,Iowa Donor Network,IAOP,2015,3640,236,56,61,238,6,24,26,101,91,653,36,89,91,61,238,61,24,214,51,10,84,16,90,10,51,10,84,16,305
 IAOP-OP1 Iowa Donor Network,Iowa Donor Network,IAOP,2016,3638,238,57,55,189,7,24,23,79,72,659,29,77,81,55,189,55,25,164,45,10,82,18,87,13,45,10,82,18,306
 ILIP-OP1 Gift of Hope,Gift of Hope,ILIP,1999,21524,1087,,273,1008,5,,25,93,78,3047,33,,,273,1008,273,21,987,263,10,96,4,98,2,263,10,96,4,307
 ILIP-OP1 Gift of Hope,Gift of Hope,ILIP,2000,20865,1094,,287,966,5,,26,88,78,3056,32,,,287,966,287,14,908,266,7,93,2,94,1,266,7,93,2,308
 ILIP-OP1 Gift of Hope,Gift of Hope,ILIP,2001,20069,1065,,249,825,5,,23,77,72,2965,28,,,249,825,249,8,817,245,4,98,2,99,1,245,4,98,2,309
 ILIP-OP1 Gift of Hope,Gift of Hope,ILIP,2002,19786,1047,,289,992,5,,28,95,87,2913,34,,,289,992,289,26,965,276,12,96,4,97,3,276,12,96,4,310
 ILIP-OP1 Gift of Hope,Gift of Hope,ILIP,2003,19315,1019,,309,1072,5,,30,105,95,2821,38,,,309,1072,309,78,994,278,31,90,10,93,7,278,31,90,10,311
 ILIP-OP1 Gift of Hope,Gift of Hope,ILIP,2004,18402,979,,303,1106,5,,31,113,98,2708,41,,,303,1106,303,96,1010,267,36,88,12,91,9,267,36,88,12,312
 ILIP-OP1 Gift of Hope,Gift of Hope,ILIP,2005,18257,917,,310,1045,5,,34,114,98,2538,41,,,310,1045,310,135,910,259,51,84,16,87,13,259,51,84,16,313
 ILIP-OP1 Gift of Hope,Gift of Hope,ILIP,2006,18100,957,,305,1100,5,,32,115,102,2649,42,,,305,1100,305,72,1028,279,26,91,9,93,7,279,26,91,9,314
 ILIP-OP1 Gift of Hope,Gift of Hope,ILIP,2007,17472,941,,268,975,5,,28,104,85,2592,38,,,268,975,268,86,889,236,32,88,12,91,9,236,32,88,12,315
 ILIP-OP1 Gift of Hope,Gift of Hope,ILIP,2008,17177,925,308,274,984,5,33,30,106,91,2556,38,,,274,984,274,89,895,239,35,87,13,91,9,239,35,87,13,316
 ILIP-OP1 Gift of Hope,Gift of Hope,ILIP,2009,16636,934,276,285,1017,6,30,31,109,97,2574,40,,,285,1017,285,140,877,229,56,80,20,86,14,229,56,80,20,317
 ILIP-OP1 Gift of Hope,Gift of Hope,ILIP,2010,16336,907,272,259,942,6,30,29,104,88,2499,38,,,259,942,259,108,834,218,41,84,16,89,11,218,41,84,16,318
 ILIP-OP1 Gift of Hope,Gift of Hope,ILIP,2011,16201,901,305,287,985,6,34,32,109,96,2484,40,78,81,287,985,287,95,890,249,38,87,13,90,10,249,38,87,13,319
 ILIP-OP1 Gift of Hope,Gift of Hope,ILIP,2012,15968,885,291,270,925,6,33,30,104,91,2440,38,77,80,270,925,270,78,847,233,37,86,14,92,8,233,37,86,14,320
 ILIP-OP1 Gift of Hope,Gift of Hope,ILIP,2013,15515,931,322,323,1047,6,35,35,112,99,2559,41,76,81,323,1047,323,134,913,265,58,82,18,87,13,265,58,82,18,321
 ILIP-OP1 Gift of Hope,Gift of Hope,ILIP,2014,16037,949,355,336,1187,6,37,35,125,108,2615,45,75,79,336,1187,336,136,1051,278,58,83,17,89,11,278,58,83,17,322
 ILIP-OP1 Gift of Hope,Gift of Hope,ILIP,2015,16235,936,397,379,1347,6,42,40,144,115,2588,52,72,77,379,1347,379,191,1156,306,73,81,19,86,14,306,73,81,19,323
 ILIP-OP1 Gift of Hope,Gift of Hope,ILIP,2016,16488,985,441,392,1463,6,45,40,149,126,2712,54,67,73,392,1463,392,208,1255,309,83,79,21,86,14,309,83,79,21,324
 INOP-OP1 Indiana Donor Network,Indiana Donor Network,INOP,1999,9830,471,,84,315,5,,18,67,63,1322,24,,,84,315,84,0,315,84,0,100,0,100,0,84,0,100,0,325
 INOP-OP1 Indiana Donor Network,Indiana Donor Network,INOP,2000,9691,491,,83,335,5,,17,68,64,1379,24,,,83,335,83,0,335,83,0,100,0,100,0,83,0,100,0,326
 INOP-OP1 Indiana Donor Network,Indiana Donor Network,INOP,2001,9264,471,,100,409,5,,21,87,79,1316,31,,,100,409,100,0,409,100,0,100,0,100,0,100,0,100,0,327
 INOP-OP1 Indiana Donor Network,Indiana Donor Network,INOP,2002,9017,483,,130,498,5,,27,103,92,1338,37,,,130,498,130,0,498,130,0,100,0,100,0,130,0,100,0,328
 INOP-OP1 Indiana Donor Network,Indiana Donor Network,INOP,2003,9042,497,,156,591,5,,31,119,102,1380,43,,,156,591,156,0,591,156,0,100,0,100,0,156,0,100,0,329
 INOP-OP1 Indiana Donor Network,Indiana Donor Network,INOP,2004,8680,482,,161,613,6,,33,127,109,1337,46,,,161,613,161,3,610,160,1,99,1,100,0,160,1,99,1,330
 INOP-OP1 Indiana Donor Network,Indiana Donor Network,INOP,2005,8758,500,,170,652,6,,34,130,115,1381,47,,,170,652,170,24,628,162,8,95,5,96,4,162,8,95,5,331
 INOP-OP1 Indiana Donor Network,Indiana Donor Network,INOP,2006,8855,484,,141,541,5,,29,112,93,1335,41,,,141,541,141,22,519,134,7,95,5,96,4,134,7,95,5,332
 INOP-OP1 Indiana Donor Network,Indiana Donor Network,INOP,2007,8331,482,,128,498,6,,27,103,89,1322,38,,,128,498,128,15,483,122,6,95,5,97,3,122,6,95,5,333
 INOP-OP1 Indiana Donor Network,Indiana Donor Network,INOP,2008,8750,501,175,138,542,6,35,28,108,88,1379,39,,,138,542,138,33,509,129,9,93,7,94,6,129,9,93,7,334
 INOP-OP1 Indiana Donor Network,Indiana Donor Network,INOP,2009,8738,523,152,145,588,6,29,28,112,93,1443,41,,,145,588,145,43,545,130,15,90,10,93,7,130,15,90,10,335
 INOP-OP1 Indiana Donor Network,Indiana Donor Network,INOP,2010,8742,531,191,150,633,6,36,28,119,99,1458,43,,,150,633,150,15,618,144,6,96,4,98,2,144,6,96,4,336
 INOP-OP1 Indiana Donor Network,Indiana Donor Network,INOP,2011,8912,540,165,145,602,6,31,27,111,92,1483,41,76,78,145,602,145,54,548,127,18,88,12,91,9,127,18,88,12,337
 INOP-OP1 Indiana Donor Network,Indiana Donor Network,INOP,2012,8796,575,178,154,609,7,31,27,106,92,1575,39,76,78,154,609,154,45,564,138,16,90,10,93,7,138,16,90,10,338
 INOP-OP1 Indiana Donor Network,Indiana Donor Network,INOP,2013,9049,552,155,139,548,6,28,25,99,82,1523,36,75,79,139,548,139,54,494,119,20,86,14,90,10,119,20,86,14,339
 INOP-OP1 Indiana Donor Network,Indiana Donor Network,INOP,2014,9134,583,188,156,595,6,32,27,102,87,1603,37,73,76,156,595,156,53,542,138,18,88,12,91,9,138,18,88,12,340
 INOP-OP1 Indiana Donor Network,Indiana Donor Network,INOP,2015,9292,583,198,175,722,6,34,30,124,108,1605,45,80,81,175,722,175,62,660,158,17,90,10,91,9,158,17,90,10,341
 INOP-OP1 Indiana Donor Network,Indiana Donor Network,INOP,2016,9495,611,183,170,681,6,30,28,112,99,1679,41,79,82,170,681,170,78,603,147,23,86,14,89,11,147,23,86,14,342
 KYDA-OP1 KY Organ Donor Affiliates,KY Organ Donor Affiliates,KYDA,1999,9197,457,,85,326,5,,19,71,64,1297,25,,,85,326,85,2,324,84,1,99,1,99,1,84,1,99,1,343
 KYDA-OP1 KY Organ Donor Affiliates,KY Organ Donor Affiliates,KYDA,2000,8995,419,,84,313,5,,20,75,66,1191,26,,,84,313,84,2,311,83,1,99,1,99,1,83,1,99,1,344
 KYDA-OP1 KY Organ Donor Affiliates,KY Organ Donor Affiliates,KYDA,2001,8856,422,,70,264,5,,17,63,57,1190,22,,,70,264,70,2,262,69,1,99,1,99,1,69,1,99,1,345
 KYDA-OP1 KY Organ Donor Affiliates,KY Organ Donor Affiliates,KYDA,2002,9098,432,,89,352,5,,21,82,76,1215,29,,,89,352,89,0,352,89,0,100,0,100,0,89,0,100,0,346
 KYDA-OP1 KY Organ Donor Affiliates,KY Organ Donor Affiliates,KYDA,2003,8523,410,,93,327,5,,23,80,73,1153,28,,,93,327,93,3,324,92,1,99,1,99,1,92,1,99,1,347
 KYDA-OP1 KY Organ Donor Affiliates,KY Organ Donor Affiliates,KYDA,2004,8225,403,,80,293,5,,20,73,65,1129,26,,,80,293,80,0,293,80,0,100,0,100,0,80,0,100,0,348
 KYDA-OP1 KY Organ Donor Affiliates,KY Organ Donor Affiliates,KYDA,2005,8344,404,,87,336,5,,22,83,74,1129,30,,,87,336,87,6,330,85,2,98,2,98,2,85,2,98,2,349
 KYDA-OP1 KY Organ Donor Affiliates,KY Organ Donor Affiliates,KYDA,2006,8415,453,,110,366,5,,24,81,71,1259,29,,,110,366,110,5,361,108,2,98,2,99,1,108,2,98,2,350
 KYDA-OP1 KY Organ Donor Affiliates,KY Organ Donor Affiliates,KYDA,2007,8331,432,,101,370,5,,23,86,74,1195,31,,,101,370,101,3,367,100,1,99,1,99,1,100,1,99,1,351
 KYDA-OP1 KY Organ Donor Affiliates,KY Organ Donor Affiliates,KYDA,2008,8401,424,137,105,367,5,32,25,87,72,1177,31,,,105,367,105,13,354,100,5,95,5,96,4,100,5,95,5,352
 KYDA-OP1 KY Organ Donor Affiliates,KY Organ Donor Affiliates,KYDA,2009,8594,464,135,101,347,5,29,22,75,65,1294,27,,,101,347,101,15,332,95,6,94,6,96,4,95,6,94,6,353
 KYDA-OP1 KY Organ Donor Affiliates,KY Organ Donor Affiliates,KYDA,2010,8771,492,169,128,446,6,34,26,91,81,1365,33,,,128,446,128,11,435,123,5,96,4,98,2,123,5,96,4,354
 KYDA-OP1 KY Organ Donor Affiliates,KY Organ Donor Affiliates,KYDA,2011,8820,458,133,100,342,5,29,22,75,65,1275,27,71,72,100,342,100,6,336,97,3,97,3,98,2,97,3,97,3,355
 KYDA-OP1 KY Organ Donor Affiliates,KY Organ Donor Affiliates,KYDA,2012,8813,485,96,88,317,6,20,18,65,56,1345,24,85,86,88,317,88,11,306,83,5,94,6,97,3,83,5,94,6,356
 KYDA-OP1 KY Organ Donor Affiliates,KY Organ Donor Affiliates,KYDA,2013,8620,470,126,109,364,5,27,23,77,67,1298,28,82,83,109,364,109,7,357,106,3,97,3,98,2,106,3,97,3,357
 KYDA-OP1 KY Organ Donor Affiliates,KY Organ Donor Affiliates,KYDA,2014,8980,496,126,103,396,6,25,21,80,67,1375,29,79,80,103,396,103,6,390,101,2,98,2,98,2,101,2,98,2,358
 KYDA-OP1 KY Organ Donor Affiliates,KY Organ Donor Affiliates,KYDA,2015,9177,520,111,100,342,6,21,19,66,58,1433,24,82,83,100,342,100,13,329,94,6,94,6,96,4,94,6,94,6,359
 KYDA-OP1 KY Organ Donor Affiliates,KY Organ Donor Affiliates,KYDA,2016,9339,541,120,110,384,6,22,20,71,60,1489,26,79,81,110,384,110,36,348,97,13,88,12,91,9,97,13,88,12,360
 LAOP-OP1 Louisiana Organ Procurement Agency,Louisiana Organ Procurement Agency,LAOP,1999,10227,568,,90,349,6,,16,61,55,1587,22,,,90,349,90,0,349,90,0,100,0,100,0,90,0,100,0,361
 LAOP-OP1 Louisiana Organ Procurement Agency,Louisiana Organ Procurement Agency,LAOP,2000,10073,555,,100,386,6,,18,70,66,1547,25,,,100,386,100,0,386,100,0,100,0,100,0,100,0,100,0,362
 LAOP-OP1 Louisiana Organ Procurement Agency,Louisiana Organ Procurement Agency,LAOP,2001,9963,544,,117,435,5,,22,80,73,1518,29,,,117,435,117,3,432,116,1,99,1,99,1,116,1,99,1,363
 LAOP-OP1 Louisiana Organ Procurement Agency,Louisiana Organ Procurement Agency,LAOP,2002,9730,531,,111,414,5,,21,78,73,1472,28,,,111,414,111,0,414,111,0,100,0,100,0,111,0,100,0,364
 LAOP-OP1 Louisiana Organ Procurement Agency,Louisiana Organ Procurement Agency,LAOP,2003,9526,498,,119,430,5,,24,86,77,1378,31,,,119,430,119,5,425,117,2,98,2,99,1,117,2,98,2,365
 LAOP-OP1 Louisiana Organ Procurement Agency,Louisiana Organ Procurement Agency,LAOP,2004,9197,531,,159,520,6,,30,98,89,1464,36,,,159,520,159,17,503,151,8,95,5,97,3,151,8,95,5,366
 LAOP-OP1 Louisiana Organ Procurement Agency,Louisiana Organ Procurement Agency,LAOP,2005,9130,495,,159,531,5,,32,107,96,1362,39,,,159,531,159,45,486,140,19,88,12,92,8,140,19,88,12,367
 LAOP-OP1 Louisiana Organ Procurement Agency,Louisiana Organ Procurement Agency,LAOP,2006,8373,446,,133,441,5,,30,99,90,1229,36,,,133,441,133,26,415,122,11,92,8,94,6,122,11,92,8,368
 LAOP-OP1 Louisiana Organ Procurement Agency,Louisiana Organ Procurement Agency,LAOP,2007,8131,498,,160,516,6,,32,104,92,1372,38,,,160,516,160,38,478,146,14,91,9,93,7,146,14,91,9,369
 LAOP-OP1 Louisiana Organ Procurement Agency,Louisiana Organ Procurement Agency,LAOP,2008,7978,468,253,151,488,6,54,32,104,94,1282,38,,,151,488,151,32,456,139,12,92,8,93,7,139,12,92,8,370
 LAOP-OP1 Louisiana Organ Procurement Agency,Louisiana Organ Procurement Agency,LAOP,2009,7809,449,211,152,534,6,47,34,119,109,1237,43,,,152,534,152,36,498,139,13,91,9,93,7,139,13,91,9,371
 LAOP-OP1 Louisiana Organ Procurement Agency,Louisiana Organ Procurement Agency,LAOP,2010,7509,426,165,161,583,6,39,38,137,123,1176,50,,,161,583,161,36,547,146,15,91,9,94,6,146,15,91,9,372
 LAOP-OP1 Louisiana Organ Procurement Agency,Louisiana Organ Procurement Agency,LAOP,2011,6962,429,155,144,571,6,36,34,133,120,1175,49,81,83,144,571,144,34,537,132,12,92,8,94,6,132,12,92,8,373
 LAOP-OP1 Louisiana Organ Procurement Agency,Louisiana Organ Procurement Agency,LAOP,2012,7460,463,185,170,618,6,40,37,133,120,1275,48,80,82,170,618,170,32,586,157,13,92,8,95,5,157,13,92,8,374
 LAOP-OP1 Louisiana Organ Procurement Agency,Louisiana Organ Procurement Agency,LAOP,2013,8161,495,191,150,543,6,39,30,110,100,1359,40,74,75,150,543,150,11,532,145,5,97,3,98,2,145,5,97,3,375
 LAOP-OP1 Louisiana Organ Procurement Agency,Louisiana Organ Procurement Agency,LAOP,2014,7984,497,190,163,585,6,38,33,118,109,1362,43,78,80,163,585,163,36,549,150,13,92,8,94,6,150,13,92,8,376
 LAOP-OP1 Louisiana Organ Procurement Agency,Louisiana Organ Procurement Agency,LAOP,2015,7800,499,229,181,680,6,46,36,136,123,1369,50,71,73,181,680,181,38,642,167,14,92,8,94,6,167,14,92,8,377
 LAOP-OP1 Louisiana Organ Procurement Agency,Louisiana Organ Procurement Agency,LAOP,2016,7696,538,218,178,651,7,41,33,121,108,1479,44,76,77,178,651,178,31,620,167,11,94,6,95,5,167,11,94,6,378
 MAOB-OP1 New England Organ Bank,New England Organ Bank,MAOB,1999,18008,804,,174,644,4,,22,80,68,2265,28,,,174,644,174,8,636,170,4,98,2,99,1,170,4,98,2,379
 MAOB-OP1 New England Organ Bank,New England Organ Bank,MAOB,2000,17736,755,,178,675,4,,24,89,76,2135,32,,,178,675,178,6,669,175,3,98,2,99,1,175,3,98,2,380
 MAOB-OP1 New England Organ Bank,New England Organ Bank,MAOB,2001,17764,824,,215,771,5,,26,94,77,2324,33,,,215,771,215,24,747,203,12,94,6,97,3,203,12,94,6,381
 MAOB-OP1 New England Organ Bank,New England Organ Bank,MAOB,2002,17728,824,,195,732,5,,24,89,75,2306,32,,,195,732,195,25,707,183,12,94,6,97,3,183,12,94,6,382
 MAOB-OP1 New England Organ Bank,New England Organ Bank,MAOB,2003,17133,753,,200,743,4,,27,99,85,2106,35,,,200,743,200,46,697,179,21,90,11,94,6,179,21,90,11,383
 MAOB-OP1 New England Organ Bank,New England Organ Bank,MAOB,2004,16010,775,,195,691,5,,25,89,73,2164,32,,,195,691,195,91,600,157,38,81,19,87,13,157,38,81,19,384
 MAOB-OP1 New England Organ Bank,New England Organ Bank,MAOB,2005,15837,754,,208,750,5,,28,99,86,2097,36,,,208,750,208,140,610,158,50,76,24,81,19,158,50,76,24,385
 MAOB-OP1 New England Organ Bank,New England Organ Bank,MAOB,2006,15490,734,,229,805,5,,31,110,95,2041,39,,,229,805,229,145,660,178,51,78,22,82,18,178,51,78,22,386
 MAOB-OP1 New England Organ Bank,New England Organ Bank,MAOB,2007,15204,774,,223,789,5,,29,102,90,2150,37,,,223,789,223,136,653,167,56,75,25,83,17,167,56,75,25,387
 MAOB-OP1 New England Organ Bank,New England Organ Bank,MAOB,2008,14990,742,208,192,687,5,28,26,93,80,2052,33,,,192,687,192,105,582,147,45,77,23,85,15,147,45,77,23,388
 MAOB-OP1 New England Organ Bank,New England Organ Bank,MAOB,2009,14853,803,215,215,763,5,27,27,95,83,2226,34,,,215,763,215,161,602,152,63,71,29,79,21,152,63,71,29,389
 MAOB-OP1 New England Organ Bank,New England Organ Bank,MAOB,2010,14538,824,202,226,759,6,25,27,92,80,2287,33,,,226,759,226,171,588,154,72,68,32,77,23,154,72,68,32,390
 MAOB-OP1 New England Organ Bank,New England Organ Bank,MAOB,2011,14536,802,233,229,769,6,29,29,96,84,2230,34,72,78,229,769,229,117,652,177,52,77,23,85,15,177,52,77,23,391
 MAOB-OP1 New England Organ Bank,New England Organ Bank,MAOB,2012,14152,828,202,217,732,6,24,26,88,77,2288,32,72,79,217,732,217,169,563,150,67,69,31,77,23,150,67,69,31,392
 MAOB-OP1 New England Organ Bank,New England Organ Bank,MAOB,2013,14480,846,219,248,782,6,26,29,92,80,2348,33,72,79,248,782,248,179,603,170,78,69,31,77,23,170,78,69,31,393
 MAOB-OP1 New England Organ Bank,New England Organ Bank,MAOB,2014,14904,870,210,267,874,6,24,31,100,87,2402,36,82,88,267,874,267,209,665,180,87,67,33,76,24,180,87,67,33,394
 MAOB-OP1 New England Organ Bank,New England Organ Bank,MAOB,2015,15042,936,245,282,867,6,26,30,93,77,2583,34,75,82,282,867,282,185,682,197,85,70,30,79,21,197,85,70,30,395
 MAOB-OP1 New England Organ Bank,New England Organ Bank,MAOB,2016,15057,1009,323,338,1179,7,32,34,117,102,2777,42,76,82,338,1179,338,211,968,253,85,75,25,82,18,253,85,75,25,396
 MDPC-OP1 The Living Legacy Foundation of MD,The Living Legacy Foundation of MD,MDPC,1999,6320,312,,77,317,5,,25,102,86,881,36,,,77,317,77,0,317,77,0,100,0,100,0,77,0,100,0,397
 MDPC-OP1 The Living Legacy Foundation of MD,The Living Legacy Foundation of MD,MDPC,2000,6303,336,,83,293,5,,25,87,77,936,31,,,83,293,83,10,283,78,5,94,6,97,3,78,5,94,6,398
 MDPC-OP1 The Living Legacy Foundation of MD,The Living Legacy Foundation of MD,MDPC,2001,6259,302,,72,279,5,,24,92,73,840,33,,,72,279,72,29,250,61,11,85,15,90,10,61,11,85,15,399
 MDPC-OP1 The Living Legacy Foundation of MD,The Living Legacy Foundation of MD,MDPC,2002,6202,307,,82,297,5,,27,97,77,850,35,,,82,297,82,46,251,64,18,78,22,85,15,64,18,78,22,400
 MDPC-OP1 The Living Legacy Foundation of MD,The Living Legacy Foundation of MD,MDPC,2003,6113,305,,75,250,5,,25,82,59,843,30,,,75,250,75,39,211,62,13,83,17,84,16,62,13,83,17,401
 MDPC-OP1 The Living Legacy Foundation of MD,The Living Legacy Foundation of MD,MDPC,2004,5840,307,,100,349,5,,33,114,91,847,41,,,100,349,100,29,320,89,11,89,11,92,8,89,11,89,11,402
 MDPC-OP1 The Living Legacy Foundation of MD,The Living Legacy Foundation of MD,MDPC,2005,5987,316,,102,369,5,,32,117,95,868,43,,,102,369,102,55,314,80,22,78,22,85,15,80,22,78,22,403
 MDPC-OP1 The Living Legacy Foundation of MD,The Living Legacy Foundation of MD,MDPC,2006,5850,329,,132,515,6,,40,156,132,900,57,,,132,515,132,65,450,109,23,83,17,87,13,109,23,83,17,404
 MDPC-OP1 The Living Legacy Foundation of MD,The Living Legacy Foundation of MD,MDPC,2007,5873,351,,119,430,6,,34,122,102,958,45,,,119,430,119,84,346,86,33,72,28,80,20,86,33,72,28,405
 MDPC-OP1 The Living Legacy Foundation of MD,The Living Legacy Foundation of MD,MDPC,2008,5682,333,143,119,424,6,43,36,127,105,913,46,,,119,424,119,49,375,100,19,84,16,88,12,100,19,84,16,406
 MDPC-OP1 The Living Legacy Foundation of MD,The Living Legacy Foundation of MD,MDPC,2009,5450,344,142,120,445,6,41,35,129,110,940,47,,,120,445,120,49,396,102,18,85,15,89,11,102,18,85,15,407
 MDPC-OP1 The Living Legacy Foundation of MD,The Living Legacy Foundation of MD,MDPC,2010,5016,323,133,120,469,6,41,37,145,119,887,53,,,120,469,120,35,434,107,13,89,11,93,7,107,13,89,11,408
 MDPC-OP1 The Living Legacy Foundation of MD,The Living Legacy Foundation of MD,MDPC,2011,5095,351,146,124,472,7,42,35,135,110,962,49,71,74,124,472,124,40,432,110,14,89,11,92,8,110,14,89,11,409
 MDPC-OP1 The Living Legacy Foundation of MD,The Living Legacy Foundation of MD,MDPC,2012,5006,326,147,142,533,7,45,44,163,132,887,60,76,80,142,533,142,56,477,123,19,87,13,89,11,123,19,87,13,410
 MDPC-OP1 The Living Legacy Foundation of MD,The Living Legacy Foundation of MD,MDPC,2013,5011,318,134,138,442,6,42,43,139,101,872,51,64,74,138,442,138,69,373,113,25,82,18,84,16,113,25,82,18,411
 MDPC-OP1 The Living Legacy Foundation of MD,The Living Legacy Foundation of MD,MDPC,2014,5141,344,149,147,469,7,43,43,137,106,943,50,70,77,147,469,147,64,405,123,24,84,16,86,14,123,24,84,16,412
 MDPC-OP1 The Living Legacy Foundation of MD,The Living Legacy Foundation of MD,MDPC,2015,5041,364,171,152,541,7,47,42,148,119,995,54,73,76,152,541,152,53,488,132,20,87,13,90,10,132,20,87,13,413
 MDPC-OP1 The Living Legacy Foundation of MD,The Living Legacy Foundation of MD,MDPC,2016,5130,376,203,188,669,7,54,50,178,143,1026,65,76,79,188,669,188,67,602,166,22,88,12,90,10,166,22,88,12,414
 MIOP-OP1 Gift of Life Michigan,Gift of Life Michigan,MIOP,1999,16915,886,,186,660,5,,21,74,65,2485,27,,,186,660,186,0,660,186,0,100,0,100,0,186,0,100,0,415
 MIOP-OP1 Gift of Life Michigan,Gift of Life Michigan,MIOP,2000,16653,861,,195,698,5,,23,81,70,2401,29,,,195,698,195,2,696,194,1,99,1,100,0,194,1,99,1,416
 MIOP-OP1 Gift of Life Michigan,Gift of Life Michigan,MIOP,2001,16315,839,,214,732,5,,26,87,77,2343,31,,,214,732,214,9,723,210,4,98,2,99,1,210,4,98,2,417
 MIOP-OP1 Gift of Life Michigan,Gift of Life Michigan,MIOP,2002,16241,803,,226,768,5,,28,96,84,2233,34,,,226,768,226,15,753,220,6,97,3,98,2,220,6,97,3,418
 MIOP-OP1 Gift of Life Michigan,Gift of Life Michigan,MIOP,2003,15480,801,,211,688,5,,26,86,74,2221,31,,,211,688,211,12,676,206,5,98,2,98,2,206,5,98,2,419
 MIOP-OP1 Gift of Life Michigan,Gift of Life Michigan,MIOP,2004,14633,797,,276,913,5,,35,115,98,2213,41,,,276,913,276,41,872,263,13,95,5,96,4,263,13,95,5,420
 MIOP-OP1 Gift of Life Michigan,Gift of Life Michigan,MIOP,2005,14885,811,,269,963,5,,33,119,98,2237,43,,,269,963,269,45,918,255,14,95,5,95,5,255,14,95,5,421
 MIOP-OP1 Gift of Life Michigan,Gift of Life Michigan,MIOP,2006,14566,743,,291,1057,5,,39,142,121,2054,51,,,291,1057,291,84,973,260,31,89,11,92,8,260,31,89,11,422
 MIOP-OP1 Gift of Life Michigan,Gift of Life Michigan,MIOP,2007,14622,781,,301,1040,5,,39,133,112,2158,48,,,301,1040,301,119,921,248,53,82,18,89,11,248,53,82,18,423
 MIOP-OP1 Gift of Life Michigan,Gift of Life Michigan,MIOP,2008,14866,824,315,320,1091,6,38,39,132,112,2275,48,,,320,1091,320,207,884,231,89,72,28,81,19,231,89,72,28,424
 MIOP-OP1 Gift of Life Michigan,Gift of Life Michigan,MIOP,2009,14317,791,272,283,1017,6,34,36,129,109,2180,47,,,283,1017,283,132,885,226,57,80,20,87,13,226,57,80,20,425
 MIOP-OP1 Gift of Life Michigan,Gift of Life Michigan,MIOP,2010,14305,838,249,289,994,6,30,34,119,94,2315,43,,,289,994,289,196,798,207,82,72,28,80,20,207,82,72,28,426
 MIOP-OP1 Gift of Life Michigan,Gift of Life Michigan,MIOP,2011,14594,858,254,266,937,6,30,31,109,92,2360,40,73,79,266,937,266,138,799,209,57,79,21,85,15,209,57,79,21,427
 MIOP-OP1 Gift of Life Michigan,Gift of Life Michigan,MIOP,2012,14206,825,259,261,902,6,31,32,109,94,2281,40,74,80,261,902,261,128,774,203,58,78,22,86,14,203,58,78,22,428
 MIOP-OP1 Gift of Life Michigan,Gift of Life Michigan,MIOP,2013,14460,842,281,283,1063,6,33,34,126,109,2330,46,67,75,283,1063,283,186,877,201,82,71,29,83,17,201,82,71,29,429
 MIOP-OP1 Gift of Life Michigan,Gift of Life Michigan,MIOP,2014,14575,810,279,254,930,6,34,31,115,98,2244,41,73,77,254,930,254,106,824,210,44,83,17,89,11,210,44,83,17,430
 MIOP-OP1 Gift of Life Michigan,Gift of Life Michigan,MIOP,2015,14711,844,286,285,1027,6,34,34,122,104,2331,44,69,76,285,1027,285,183,844,211,74,74,26,82,18,211,74,74,26,431
 MIOP-OP1 Gift of Life Michigan,Gift of Life Michigan,MIOP,2016,14730,870,270,299,1033,6,31,34,119,101,2417,43,74,81,299,1033,299,214,819,211,88,71,29,79,21,211,88,71,29,432
 MNOP-OP1 LifeSource Upper Midwest OPO,LifeSource Upper Midwest OPO,MNOP,1999,7974,437,,150,632,5,,34,145,133,1227,52,,,150,632,150,0,632,150,0,100,0,100,0,150,0,100,0,433
 MNOP-OP1 LifeSource Upper Midwest OPO,LifeSource Upper Midwest OPO,MNOP,2000,7851,434,,160,631,6,,37,145,129,1222,52,,,160,631,160,0,631,160,0,100,0,100,0,160,0,100,0,434
 MNOP-OP1 LifeSource Upper Midwest OPO,LifeSource Upper Midwest OPO,MNOP,2001,7814,428,,148,578,5,,35,135,117,1197,48,,,148,578,148,0,578,148,0,100,0,100,0,148,0,100,0,435
 MNOP-OP1 LifeSource Upper Midwest OPO,LifeSource Upper Midwest OPO,MNOP,2002,7633,431,,145,580,6,,34,135,117,1199,48,,,145,580,145,0,580,145,0,100,0,100,0,145,0,100,0,436
 MNOP-OP1 LifeSource Upper Midwest OPO,LifeSource Upper Midwest OPO,MNOP,2003,7364,439,,149,599,6,,34,137,125,1220,49,,,149,599,149,0,599,149,0,100,0,100,0,149,0,100,0,437
 MNOP-OP1 LifeSource Upper Midwest OPO,LifeSource Upper Midwest OPO,MNOP,2004,6974,427,,147,590,6,,34,138,126,1184,50,,,147,590,147,3,587,146,1,99,1,99,1,146,1,99,1,438
 MNOP-OP1 LifeSource Upper Midwest OPO,LifeSource Upper Midwest OPO,MNOP,2005,7009,439,,181,699,6,,41,159,137,1212,58,,,181,699,181,27,672,173,8,96,4,96,4,173,8,96,4,439
 MNOP-OP1 LifeSource Upper Midwest OPO,LifeSource Upper Midwest OPO,MNOP,2006,7014,445,,174,687,6,,39,155,136,1225,56,,,174,687,174,48,639,156,18,90,10,93,7,156,18,90,10,440
 MNOP-OP1 LifeSource Upper Midwest OPO,LifeSource Upper Midwest OPO,MNOP,2007,7021,431,,144,561,6,,33,130,118,1189,47,,,144,561,144,29,532,133,11,92,8,95,5,133,11,92,8,441
 MNOP-OP1 LifeSource Upper Midwest OPO,LifeSource Upper Midwest OPO,MNOP,2008,7229,435,171,147,535,6,39,34,123,109,1200,45,,,147,535,147,57,478,128,19,87,13,89,11,128,19,87,13,442
 MNOP-OP1 LifeSource Upper Midwest OPO,LifeSource Upper Midwest OPO,MNOP,2009,7163,488,196,175,648,7,40,36,133,119,1346,48,,,175,648,175,53,595,158,17,90,10,92,8,158,17,90,10,443
 MNOP-OP1 LifeSource Upper Midwest OPO,LifeSource Upper Midwest OPO,MNOP,2010,6877,467,162,149,569,7,35,32,122,107,1287,44,,,149,569,149,59,510,130,19,87,13,90,10,130,19,87,13,444
 MNOP-OP1 LifeSource Upper Midwest OPO,LifeSource Upper Midwest OPO,MNOP,2011,7127,518,165,160,597,7,32,31,115,102,1426,42,76,80,160,597,160,76,521,136,24,85,15,87,13,136,24,85,15,445
 MNOP-OP1 LifeSource Upper Midwest OPO,LifeSource Upper Midwest OPO,MNOP,2012,7076,507,161,153,553,7,32,30,109,92,1394,40,71,77,153,553,153,70,483,129,24,84,16,87,13,129,24,84,16,446
 MNOP-OP1 LifeSource Upper Midwest OPO,LifeSource Upper Midwest OPO,MNOP,2013,7142,431,141,133,539,6,33,31,125,114,1197,45,78,81,133,539,133,42,497,119,14,89,11,92,8,119,14,89,11,447
 MNOP-OP1 LifeSource Upper Midwest OPO,LifeSource Upper Midwest OPO,MNOP,2014,7325,501,152,150,585,7,30,30,117,100,1389,42,74,79,150,585,150,89,496,123,27,82,18,85,15,123,27,82,18,448
 MNOP-OP1 LifeSource Upper Midwest OPO,LifeSource Upper Midwest OPO,MNOP,2015,7578,498,138,154,580,7,28,31,117,99,1377,42,73,81,154,580,154,115,465,115,39,75,25,80,20,115,39,75,25,449
 MNOP-OP1 LifeSource Upper Midwest OPO,LifeSource Upper Midwest OPO,MNOP,2016,7748,554,172,179,665,7,31,32,120,106,1537,43,71,78,179,665,179,137,528,129,50,72,28,79,21,129,50,72,28,450
 MOMA-OP1 Mid-America Transplant Svcs,Mid-America Transplant Svcs,MOMA,1999,8872,450,,102,348,5,,23,77,65,1278,27,,,102,348,102,0,345,101,0,99,0,99,0,101,0,99,0,451
 MOMA-OP1 Mid-America Transplant Svcs,Mid-America Transplant Svcs,MOMA,2000,8604,462,,110,397,5,,24,86,79,1297,31,,,110,397,110,0,397,110,0,100,0,100,0,110,0,100,0,452
 MOMA-OP1 Mid-America Transplant Svcs,Mid-America Transplant Svcs,MOMA,2001,8335,445,,107,389,5,,24,87,79,1248,31,,,107,389,107,6,383,104,3,97,3,98,2,104,3,97,3,453
 MOMA-OP1 Mid-America Transplant Svcs,Mid-America Transplant Svcs,MOMA,2002,8548,437,,94,349,5,,22,80,72,1225,28,,,94,349,94,10,339,91,3,97,3,97,3,91,3,97,3,454
 MOMA-OP1 Mid-America Transplant Svcs,Mid-America Transplant Svcs,MOMA,2003,8123,393,,107,351,5,,27,89,77,1106,32,,,107,351,107,10,341,103,4,96,4,97,3,103,4,96,4,455
 MOMA-OP1 Mid-America Transplant Svcs,Mid-America Transplant Svcs,MOMA,2004,7871,439,,112,362,6,,26,83,72,1223,30,,,112,362,112,25,337,103,9,92,8,93,7,103,9,92,8,456
 MOMA-OP1 Mid-America Transplant Svcs,Mid-America Transplant Svcs,MOMA,2005,7752,449,,141,459,6,,31,102,88,1245,37,,,141,459,141,23,436,133,8,94,6,95,5,133,8,94,6,457
 MOMA-OP1 Mid-America Transplant Svcs,Mid-America Transplant Svcs,MOMA,2006,7690,443,,140,489,6,,32,110,96,1222,40,,,140,489,140,42,447,123,17,88,12,91,9,123,17,88,12,458
 MOMA-OP1 Mid-America Transplant Svcs,Mid-America Transplant Svcs,MOMA,2007,7561,468,,153,548,6,,33,117,106,1290,42,,,153,548,153,50,498,134,19,88,12,91,9,134,19,88,12,459
 MOMA-OP1 Mid-America Transplant Svcs,Mid-America Transplant Svcs,MOMA,2008,8013,465,171,144,550,6,37,31,118,98,1294,43,,,144,550,144,44,506,130,14,90,10,92,8,130,14,90,10,460
 MOMA-OP1 Mid-America Transplant Svcs,Mid-America Transplant Svcs,MOMA,2009,7700,466,173,168,576,6,37,36,124,109,1291,45,,,168,576,168,43,533,150,18,89,11,93,7,150,18,89,11,461
 MOMA-OP1 Mid-America Transplant Svcs,Mid-America Transplant Svcs,MOMA,2010,7418,450,167,154,550,6,37,34,122,111,1248,44,,,154,550,154,31,519,141,13,92,8,94,6,141,13,92,8,462
 MOMA-OP1 Mid-America Transplant Svcs,Mid-America Transplant Svcs,MOMA,2011,7283,497,168,155,593,7,34,31,119,112,1367,43,81,83,155,593,155,44,549,138,17,89,11,93,7,138,17,89,11,463
 MOMA-OP1 Mid-America Transplant Svcs,Mid-America Transplant Svcs,MOMA,2012,7234,459,196,165,618,6,43,36,135,122,1268,49,69,73,165,618,165,51,567,145,20,88,12,92,8,145,20,88,12,464
 MOMA-OP1 Mid-America Transplant Svcs,Mid-America Transplant Svcs,MOMA,2013,7165,416,166,161,556,6,40,39,134,122,1148,48,79,82,161,556,161,56,500,138,23,86,14,90,10,138,23,86,14,465
 MOMA-OP1 Mid-America Transplant Svcs,Mid-America Transplant Svcs,MOMA,2014,7412,478,176,159,595,6,37,33,124,112,1320,45,74,78,159,595,159,53,542,137,22,86,14,91,9,137,22,86,14,466
 MOMA-OP1 Mid-America Transplant Svcs,Mid-America Transplant Svcs,MOMA,2015,7499,475,245,190,664,6,52,40,140,130,1311,51,66,69,190,664,190,51,613,168,22,88,12,92,8,168,22,88,12,467
 MOMA-OP1 Mid-America Transplant Svcs,Mid-America Transplant Svcs,MOMA,2016,7616,509,189,180,617,7,37,35,121,108,1396,44,74,79,180,617,180,62,555,151,29,84,16,90,10,151,29,84,16,468
 MSOP-OP1 Mississippi Organ Recovery Agency,Mississippi Organ Recovery Agency,MSOP,1999,5742,311,,45,148,5,,14,48,43,865,17,,,45,148,45,0,148,45,0,100,0,100,0,45,0,100,0,469
 MSOP-OP1 Mississippi Organ Recovery Agency,Mississippi Organ Recovery Agency,MSOP,2000,5697,353,,52,169,6,,15,48,41,977,17,,,52,169,52,0,169,52,0,100,0,100,0,52,0,100,0,470
 MSOP-OP1 Mississippi Organ Recovery Agency,Mississippi Organ Recovery Agency,MSOP,2001,5619,335,,47,171,6,,14,51,45,934,18,,,47,171,47,0,171,47,0,100,0,100,0,47,0,100,0,471
 MSOP-OP1 Mississippi Organ Recovery Agency,Mississippi Organ Recovery Agency,MSOP,2002,5561,326,,60,191,6,,18,59,44,907,21,,,60,191,60,0,191,60,0,100,0,100,0,60,0,100,0,472
 MSOP-OP1 Mississippi Organ Recovery Agency,Mississippi Organ Recovery Agency,MSOP,2003,5540,301,,55,204,5,,18,68,61,834,24,,,55,204,55,0,204,55,0,100,0,100,0,55,0,100,0,473
 MSOP-OP1 Mississippi Organ Recovery Agency,Mississippi Organ Recovery Agency,MSOP,2004,5196,302,,50,169,6,,17,56,48,838,20,,,50,169,50,0,169,50,0,100,0,100,0,50,0,100,0,474
 MSOP-OP1 Mississippi Organ Recovery Agency,Mississippi Organ Recovery Agency,MSOP,2005,5271,325,,78,252,6,,24,77,65,893,28,,,78,252,78,0,252,78,0,100,0,100,0,78,0,100,0,475
 MSOP-OP1 Mississippi Organ Recovery Agency,Mississippi Organ Recovery Agency,MSOP,2006,5042,295,,65,204,6,,22,69,57,810,25,,,65,204,65,0,204,65,0,100,0,100,0,65,0,100,0,476
 MSOP-OP1 Mississippi Organ Recovery Agency,Mississippi Organ Recovery Agency,MSOP,2007,4966,277,,66,233,6,,24,84,71,765,30,,,66,233,66,7,226,63,3,95,5,97,3,63,3,95,5,477
 MSOP-OP1 Mississippi Organ Recovery Agency,Mississippi Organ Recovery Agency,MSOP,2008,5238,299,106,82,271,6,35,27,91,75,828,33,,,82,271,82,18,253,73,9,89,11,93,7,73,9,89,11,478
 MSOP-OP1 Mississippi Organ Recovery Agency,Mississippi Organ Recovery Agency,MSOP,2009,4922,296,110,78,286,6,37,26,97,86,814,35,,,78,286,78,2,284,77,1,99,1,99,1,77,1,99,1,479
 MSOP-OP1 Mississippi Organ Recovery Agency,Mississippi Organ Recovery Agency,MSOP,2010,5047,316,92,74,261,6,29,23,83,66,873,30,,,74,261,74,4,257,72,2,97,3,98,2,72,2,97,3,480
 MSOP-OP1 Mississippi Organ Recovery Agency,Mississippi Organ Recovery Agency,MSOP,2011,5047,307,79,72,265,6,26,23,86,79,843,31,75,78,72,265,72,7,258,69,3,96,4,97,3,69,3,96,4,481
 MSOP-OP1 Mississippi Organ Recovery Agency,Mississippi Organ Recovery Agency,MSOP,2012,5135,308,99,76,286,6,32,25,93,81,842,34,75,75,76,286,76,2,284,75,1,99,1,99,1,75,1,99,1,482
 MSOP-OP1 Mississippi Organ Recovery Agency,Mississippi Organ Recovery Agency,MSOP,2013,5357,309,76,70,264,6,25,23,85,74,860,31,78,80,70,264,70,18,246,63,7,90,10,93,7,63,7,90,10,483
 MSOP-OP1 Mississippi Organ Recovery Agency,Mississippi Organ Recovery Agency,MSOP,2014,5227,311,80,61,216,6,26,20,69,64,858,25,70,72,61,216,61,6,210,58,3,95,5,97,3,58,3,95,5,484
 MSOP-OP1 Mississippi Organ Recovery Agency,Mississippi Organ Recovery Agency,MSOP,2015,5345,323,91,68,232,6,28,21,72,61,893,26,59,65,68,232,68,15,217,61,7,90,10,94,6,61,7,90,10,485
 MSOP-OP1 Mississippi Organ Recovery Agency,Mississippi Organ Recovery Agency,MSOP,2016,5240,305,92,88,295,6,30,29,97,86,840,35,78,81,88,295,88,21,274,78,10,89,11,93,7,78,10,89,11,486
 MWOB-OP1 Midwest Transplant Network,Midwest Transplant Network,MWOB,1999,9225,504,,104,389,5,,21,77,72,1415,27,,,104,389,104,4,385,102,2,98,2,99,1,102,2,98,2,487
 MWOB-OP1 Midwest Transplant Network,Midwest Transplant Network,MWOB,2000,8680,497,,110,432,6,,22,87,78,1395,31,,,110,432,110,2,430,109,1,99,1,100,0,109,1,99,1,488
 MWOB-OP1 Midwest Transplant Network,Midwest Transplant Network,MWOB,2001,8829,487,,117,459,6,,24,94,83,1360,34,,,117,459,117,4,455,115,2,98,2,99,1,115,2,98,2,489
 MWOB-OP1 Midwest Transplant Network,Midwest Transplant Network,MWOB,2002,8496,487,,118,478,6,,24,98,86,1354,35,,,118,478,118,11,467,113,5,96,4,98,2,113,5,96,4,490
 MWOB-OP1 Midwest Transplant Network,Midwest Transplant Network,MWOB,2003,8114,449,,120,439,6,,27,98,83,1248,35,,,120,439,120,8,431,117,3,98,3,98,2,117,3,98,3,491
 MWOB-OP1 Midwest Transplant Network,Midwest Transplant Network,MWOB,2004,7804,439,,154,578,6,,35,132,115,1221,47,,,154,578,154,86,492,126,28,82,18,85,15,126,28,82,18,492
 MWOB-OP1 Midwest Transplant Network,Midwest Transplant Network,MWOB,2005,7857,472,,169,602,6,,36,128,109,1301,46,,,169,602,169,100,502,136,33,80,20,83,17,136,33,80,20,493
 MWOB-OP1 Midwest Transplant Network,Midwest Transplant Network,MWOB,2006,7683,495,,201,715,6,,41,144,128,1368,52,,,201,715,201,70,645,177,24,88,12,90,10,177,24,88,12,494
 MWOB-OP1 Midwest Transplant Network,Midwest Transplant Network,MWOB,2007,7576,500,,195,683,7,,39,137,117,1380,50,,,195,683,195,68,615,169,26,87,13,90,10,169,26,87,13,495
 MWOB-OP1 Midwest Transplant Network,Midwest Transplant Network,MWOB,2008,7797,454,240,213,773,6,53,47,170,144,1254,62,,,213,773,213,73,700,188,25,88,12,91,9,188,25,88,12,496
 MWOB-OP1 Midwest Transplant Network,Midwest Transplant Network,MWOB,2009,7530,499,213,217,796,7,43,44,160,139,1367,58,,,217,796,217,79,717,183,34,84,16,90,10,183,34,84,16,497
 MWOB-OP1 Midwest Transplant Network,Midwest Transplant Network,MWOB,2010,7125,489,185,199,703,7,38,41,144,122,1346,52,,,199,703,199,82,621,161,38,81,19,88,12,161,38,81,19,498
 MWOB-OP1 Midwest Transplant Network,Midwest Transplant Network,MWOB,2011,7111,481,209,216,784,7,43,45,163,140,1322,59,80,84,216,784,216,83,701,179,37,83,17,89,11,179,37,83,17,499
 MWOB-OP1 Midwest Transplant Network,Midwest Transplant Network,MWOB,2012,7117,472,177,209,721,7,37,44,153,133,1302,55,81,86,209,721,209,110,611,158,51,76,24,85,15,158,51,76,24,500
 MWOB-OP1 Midwest Transplant Network,Midwest Transplant Network,MWOB,2013,7018,441,185,220,792,6,42,50,180,153,1212,65,82,87,220,792,220,123,669,169,51,77,23,84,16,169,51,77,23,501
 MWOB-OP1 Midwest Transplant Network,Midwest Transplant Network,MWOB,2014,7155,448,179,217,754,6,40,48,168,149,1233,61,77,84,217,754,217,121,633,162,55,75,25,84,16,162,55,75,25,502
 MWOB-OP1 Midwest Transplant Network,Midwest Transplant Network,MWOB,2015,7225,454,183,200,703,6,40,44,155,131,1252,56,73,80,200,703,200,102,601,153,47,77,24,85,15,153,47,77,24,503
 MWOB-OP1 Midwest Transplant Network,Midwest Transplant Network,MWOB,2016,7084,484,195,228,847,7,40,47,175,151,1330,64,81,86,228,847,228,136,711,172,56,75,25,84,16,172,56,75,25,504
 NCCM-IO1 LifeShare of the Carolinas,LifeShare of the Carolinas,NCCM,1999,3883,235,,49,197,6,,21,84,75,656,30,,,49,197,49,0,197,49,0,100,0,100,0,49,0,100,0,505
 NCCM-IO1 LifeShare of the Carolinas,LifeShare of the Carolinas,NCCM,2000,3966,240,,48,169,6,,20,70,67,671,25,,,48,169,48,0,169,48,0,100,0,100,0,48,0,100,0,506
 NCCM-IO1 LifeShare of the Carolinas,LifeShare of the Carolinas,NCCM,2001,3825,219,,41,161,6,,19,74,69,612,26,,,41,161,41,3,158,40,1,98,2,98,2,40,1,98,2,507
 NCCM-IO1 LifeShare of the Carolinas,LifeShare of the Carolinas,NCCM,2002,3709,235,,43,137,6,,18,58,48,650,21,,,43,137,43,0,137,43,0,100,0,100,0,43,0,100,0,508
 NCCM-IO1 LifeShare of the Carolinas,LifeShare of the Carolinas,NCCM,2003,3759,221,,45,162,6,,20,73,65,616,26,,,45,162,45,0,162,45,0,100,0,100,0,45,0,100,0,509
 NCCM-IO1 LifeShare of the Carolinas,LifeShare of the Carolinas,NCCM,2004,3677,236,,52,176,6,,22,75,66,651,27,,,52,176,52,12,164,48,4,92,8,93,7,48,4,92,8,510
 NCCM-IO1 LifeShare of the Carolinas,LifeShare of the Carolinas,NCCM,2005,3683,230,,80,288,6,,35,125,109,632,46,,,80,288,80,3,285,79,1,99,1,99,1,79,1,99,1,511
 NCCM-IO1 LifeShare of the Carolinas,LifeShare of the Carolinas,NCCM,2006,3665,232,,92,355,6,,40,153,133,639,56,,,92,355,92,16,339,86,6,93,7,95,5,86,6,93,7,512
 NCCM-IO1 LifeShare of the Carolinas,LifeShare of the Carolinas,NCCM,2007,3654,235,,85,324,6,,36,138,120,646,50,,,85,324,85,24,300,76,9,89,11,93,7,76,9,89,11,513
 NCCM-IO1 LifeShare of the Carolinas,LifeShare of the Carolinas,NCCM,2008,3683,230,98,76,278,6,43,33,121,106,632,44,,,76,278,76,14,264,70,6,92,8,95,5,70,6,92,8,514
 NCCM-IO1 LifeShare of the Carolinas,LifeShare of the Carolinas,NCCM,2009,3542,233,86,76,307,7,37,33,132,118,639,48,,,76,307,76,18,289,70,6,92,8,94,6,70,6,92,8,515
 NCCM-IO1 LifeShare of the Carolinas,LifeShare of the Carolinas,NCCM,2010,3408,220,110,88,345,6,50,40,157,145,606,57,,,88,345,88,20,325,80,8,91,9,94,6,80,8,91,9,516
 NCCM-IO1 LifeShare of the Carolinas,LifeShare of the Carolinas,NCCM,2011,3288,225,91,83,315,7,41,37,140,122,617,51,74,78,83,315,83,35,280,70,13,84,16,89,11,70,13,84,16,517
 NCCM-IO1 LifeShare of the Carolinas,LifeShare of the Carolinas,NCCM,2012,3413,214,86,87,333,6,40,41,156,127,589,57,77,81,87,333,87,33,300,75,12,86,14,90,10,75,12,86,14,518
 NCCM-IO1 LifeShare of the Carolinas,LifeShare of the Carolinas,NCCM,2013,3358,235,84,84,308,7,36,36,131,110,648,48,73,79,84,308,84,26,282,73,11,87,13,92,8,73,11,87,13,519
 NCCM-IO1 LifeShare of the Carolinas,LifeShare of the Carolinas,NCCM,2014,3336,240,89,80,294,7,37,33,123,107,656,45,71,75,80,294,80,33,261,66,14,83,18,89,11,66,14,83,18,520
 NCCM-IO1 LifeShare of the Carolinas,LifeShare of the Carolinas,NCCM,2015,3609,248,91,79,320,7,37,32,129,118,682,47,74,77,79,320,79,28,292,67,12,85,15,91,9,67,12,85,15,521
 NCCM-IO1 LifeShare of the Carolinas,LifeShare of the Carolinas,NCCM,2016,3545,263,139,104,350,7,53,40,133,115,722,48,63,67,104,350,104,37,313,88,16,85,15,89,11,88,16,85,15,522
 NCNC-OP1 Carolina Donor Services,Carolina Donor Services,NCNC,1999,12459,720,,98,383,6,,14,53,46,2027,19,,,98,383,98,9,371,93,4,95,4,97,2,93,4,95,4,523
 NCNC-OP1 Carolina Donor Services,Carolina Donor Services,NCNC,2000,12387,732,,119,481,6,,16,66,57,2056,23,,,119,481,119,0,481,119,0,100,0,100,0,119,0,100,0,524
 NCNC-OP1 Carolina Donor Services,Carolina Donor Services,NCNC,2001,12170,696,,114,426,6,,16,61,53,1951,22,,,114,426,114,5,420,111,2,97,2,99,1,111,2,97,2,525
 NCNC-OP1 Carolina Donor Services,Carolina Donor Services,NCNC,2002,11943,690,,118,463,6,,17,67,63,1933,24,,,118,463,118,5,458,116,2,98,2,99,1,116,2,98,2,526
 NCNC-OP1 Carolina Donor Services,Carolina Donor Services,NCNC,2003,12026,701,,127,488,6,,18,70,63,1950,25,,,127,488,127,17,471,120,7,94,6,97,3,120,7,94,6,527
 NCNC-OP1 Carolina Donor Services,Carolina Donor Services,NCNC,2004,11730,697,,140,518,6,,20,74,65,1932,27,,,140,518,140,21,497,132,8,94,6,96,4,132,8,94,6,528
 NCNC-OP1 Carolina Donor Services,Carolina Donor Services,NCNC,2005,11855,751,,164,606,6,,22,81,71,2085,29,,,164,606,164,40,566,149,15,91,9,93,7,149,15,91,9,529
 NCNC-OP1 Carolina Donor Services,Carolina Donor Services,NCNC,2006,12069,736,,158,587,6,,21,80,68,2038,29,,,158,587,158,25,562,148,10,94,6,96,4,148,10,94,6,530
 NCNC-OP1 Carolina Donor Services,Carolina Donor Services,NCNC,2007,12164,751,,171,586,6,,23,78,66,2076,28,,,171,586,171,77,509,141,30,82,18,87,13,141,30,82,18,531
 NCNC-OP1 Carolina Donor Services,Carolina Donor Services,NCNC,2008,11883,730,254,195,701,6,35,27,96,83,2021,35,,,195,701,195,58,643,171,24,88,12,92,8,171,24,88,12,532
 NCNC-OP1 Carolina Donor Services,Carolina Donor Services,NCNC,2009,11600,728,248,199,740,6,34,27,102,85,2005,37,,,199,740,199,60,680,177,22,89,11,92,8,177,22,89,11,533
 NCNC-OP1 Carolina Donor Services,Carolina Donor Services,NCNC,2010,11238,699,220,191,706,6,31,27,101,91,1931,37,,,191,706,191,56,650,165,26,86,14,92,8,165,26,86,14,534
 NCNC-OP1 Carolina Donor Services,Carolina Donor Services,NCNC,2011,11135,701,219,192,714,6,31,27,102,85,1928,37,67,72,192,714,192,87,627,153,39,80,20,88,12,153,39,80,20,535
 NCNC-OP1 Carolina Donor Services,Carolina Donor Services,NCNC,2012,10882,675,217,212,727,6,32,31,108,88,1865,39,70,77,212,727,212,118,609,163,49,77,23,84,16,163,49,77,23,536
 NCNC-OP1 Carolina Donor Services,Carolina Donor Services,NCNC,2013,10883,679,183,170,610,6,27,25,90,72,1877,33,64,72,170,610,170,97,513,127,43,75,25,84,16,127,43,75,25,537
 NCNC-OP1 Carolina Donor Services,Carolina Donor Services,NCNC,2014,11061,722,195,197,700,7,27,27,97,80,1984,35,69,77,197,700,197,118,582,145,52,74,26,83,17,145,52,74,26,538
 NCNC-OP1 Carolina Donor Services,Carolina Donor Services,NCNC,2015,11404,768,184,159,580,7,24,21,76,65,2116,27,66,72,159,580,159,78,502,123,36,77,23,87,13,123,36,77,23,539
 NCNC-OP1 Carolina Donor Services,Carolina Donor Services,NCNC,2016,11489,779,202,193,673,7,26,25,86,76,2144,31,69,75,193,673,193,110,563,144,49,75,25,84,16,144,49,75,25,540
 NEOR-OP1 Nebraska Organ Recovery System,Nebraska Organ Recovery System,NEOR,1999,2779,137,,28,104,5,,21,76,70,383,27,,,28,104,28,0,104,28,0,100,0,100,0,28,0,100,0,541
 NEOR-OP1 Nebraska Organ Recovery System,Nebraska Organ Recovery System,NEOR,2000,2656,134,,32,139,5,,24,103,94,377,37,,,32,139,32,0,139,32,0,100,0,100,0,32,0,100,0,542
 NEOR-OP1 Nebraska Organ Recovery System,Nebraska Organ Recovery System,NEOR,2001,2608,139,,34,130,5,,24,94,84,389,33,,,34,130,34,0,130,34,0,100,0,100,0,34,0,100,0,543
 NEOR-OP1 Nebraska Organ Recovery System,Nebraska Organ Recovery System,NEOR,2002,2688,151,,32,128,6,,21,85,70,419,31,,,32,128,32,0,128,32,0,100,0,100,0,32,0,100,0,544
 NEOR-OP1 Nebraska Organ Recovery System,Nebraska Organ Recovery System,NEOR,2003,2538,134,,33,137,5,,25,103,84,375,37,,,33,137,33,0,137,33,0,100,0,100,0,33,0,100,0,545
 NEOR-OP1 Nebraska Organ Recovery System,Nebraska Organ Recovery System,NEOR,2004,2335,122,,37,146,5,,30,120,89,337,43,,,37,146,37,0,146,37,0,100,0,100,0,37,0,100,0,546
 NEOR-OP1 Nebraska Organ Recovery System,Nebraska Organ Recovery System,NEOR,2005,2268,119,,41,164,5,,34,137,112,332,49,,,41,164,41,0,164,41,0,100,0,100,0,41,0,100,0,547
 NEOR-OP1 Nebraska Organ Recovery System,Nebraska Organ Recovery System,NEOR,2006,2299,136,,53,210,6,,39,155,136,372,56,,,53,210,53,9,201,50,3,94,6,96,4,50,3,94,6,548
 NEOR-OP1 Nebraska Organ Recovery System,Nebraska Organ Recovery System,NEOR,2007,2405,133,,46,180,6,,35,136,127,366,49,,,46,180,46,16,164,41,5,89,11,91,9,41,5,89,11,549
 NEOR-OP1 Nebraska Organ Recovery System,Nebraska Organ Recovery System,NEOR,2008,2322,120,50,33,120,5,42,28,100,84,330,36,,,33,120,33,0,120,33,0,100,0,100,0,33,0,100,0,550
 NEOR-OP1 Nebraska Organ Recovery System,Nebraska Organ Recovery System,NEOR,2009,2181,137,53,45,168,6,39,33,122,108,381,44,,,45,168,45,20,148,38,7,84,16,88,12,38,7,84,16,551
 NEOR-OP1 Nebraska Organ Recovery System,Nebraska Organ Recovery System,NEOR,2010,2235,143,55,44,153,6,39,31,107,92,398,38,,,44,153,44,18,135,38,6,86,14,88,12,38,6,86,14,552
 NEOR-OP1 Nebraska Organ Recovery System,Nebraska Organ Recovery System,NEOR,2011,2223,140,41,36,126,6,29,26,90,78,390,32,71,75,36,126,36,13,113,31,5,86,14,90,10,31,5,86,14,553
 NEOR-OP1 Nebraska Organ Recovery System,Nebraska Organ Recovery System,NEOR,2012,2154,142,48,40,139,7,34,28,98,92,391,36,69,73,40,139,40,18,121,33,7,83,18,87,13,33,7,83,18,554
 NEOR-OP1 Nebraska Organ Recovery System,Nebraska Organ Recovery System,NEOR,2013,2145,140,68,76,288,7,49,54,206,187,387,74,84,87,76,288,76,48,240,59,17,78,22,83,17,59,17,78,22,555
 NEOR-OP1 Nebraska Organ Recovery System,Nebraska Organ Recovery System,NEOR,2014,2333,145,64,74,270,6,44,51,186,162,403,67,88,90,74,270,74,32,238,62,12,84,16,88,12,62,12,84,16,556
 NEOR-OP1 Nebraska Organ Recovery System,Nebraska Organ Recovery System,NEOR,2015,2342,142,69,78,295,6,49,55,208,187,390,76,83,87,78,295,78,46,249,60,18,77,23,84,16,60,18,77,23,557
 NEOR-OP1 Nebraska Organ Recovery System,Nebraska Organ Recovery System,NEOR,2016,2348,139,60,70,244,6,43,50,175,146,388,63,75,82,70,244,70,51,193,51,19,73,27,79,21,51,19,73,27,558
 NJTO-OP1 NJ Organ and Tissue Sharing Network,NJ Organ and Tissue Sharing Network,NJTO,1999,14664,601,,134,471,4,,22,78,69,1700,28,,,134,471,134,10,459,129,4,96,3,97,2,129,4,96,3,559
 NJTO-OP1 NJ Organ and Tissue Sharing Network,NJ Organ and Tissue Sharing Network,NJTO,2000,14175,587,,145,542,4,,25,92,80,1655,33,,,145,542,145,2,540,144,1,99,1,100,0,144,1,99,1,560
 NJTO-OP1 NJ Organ and Tissue Sharing Network,NJ Organ and Tissue Sharing Network,NJTO,2001,13643,574,,134,496,4,,23,86,74,1611,31,,,134,496,134,6,490,131,3,98,2,99,1,131,3,98,2,561
 NJTO-OP1 NJ Organ and Tissue Sharing Network,NJ Organ and Tissue Sharing Network,NJTO,2002,13184,535,,118,435,4,,22,81,71,1495,29,,,118,435,118,6,429,116,2,98,2,99,1,116,2,98,2,562
 NJTO-OP1 NJ Organ and Tissue Sharing Network,NJ Organ and Tissue Sharing Network,NJTO,2003,12603,498,,129,447,4,,26,90,74,1393,32,,,129,447,129,5,442,127,2,98,2,99,1,127,2,98,2,563
 NJTO-OP1 NJ Organ and Tissue Sharing Network,NJ Organ and Tissue Sharing Network,NJTO,2004,11056,465,,159,554,4,,34,119,102,1304,42,,,159,554,159,16,538,153,6,96,4,97,3,153,6,96,4,564
 NJTO-OP1 NJ Organ and Tissue Sharing Network,NJ Organ and Tissue Sharing Network,NJTO,2005,10653,479,,167,555,4,,35,116,99,1331,42,,,167,555,167,8,547,164,3,98,2,99,1,164,3,98,2,565
 NJTO-OP1 NJ Organ and Tissue Sharing Network,NJ Organ and Tissue Sharing Network,NJTO,2006,10661,487,,162,556,5,,33,114,97,1345,41,,,162,556,162,44,512,145,17,90,10,92,8,145,17,90,10,566
 NJTO-OP1 NJ Organ and Tissue Sharing Network,NJ Organ and Tissue Sharing Network,NJTO,2007,10342,496,,155,564,5,,31,114,96,1374,41,,,155,564,155,38,526,139,16,90,10,93,7,139,16,90,10,567
 NJTO-OP1 NJ Organ and Tissue Sharing Network,NJ Organ and Tissue Sharing Network,NJTO,2008,10443,499,209,171,595,5,42,34,119,103,1382,43,,,171,595,171,46,549,151,20,88,12,92,8,151,20,88,12,568
 NJTO-OP1 NJ Organ and Tissue Sharing Network,NJ Organ and Tissue Sharing Network,NJTO,2009,9806,475,202,184,610,5,43,39,128,110,1322,46,,,184,610,184,74,536,149,35,81,19,88,12,149,35,81,19,569
 NJTO-OP1 NJ Organ and Tissue Sharing Network,NJ Organ and Tissue Sharing Network,NJTO,2010,9363,503,181,155,499,5,36,31,99,86,1389,36,,,155,499,155,70,429,123,32,79,21,86,14,123,32,79,21,570
 NJTO-OP1 NJ Organ and Tissue Sharing Network,NJ Organ and Tissue Sharing Network,NJTO,2011,9672,531,157,142,461,5,30,27,87,77,1471,31,68,74,142,461,142,68,393,108,34,76,24,85,15,108,34,76,24,571
 NJTO-OP1 NJ Organ and Tissue Sharing Network,NJ Organ and Tissue Sharing Network,NJTO,2012,9361,510,125,139,451,5,24,27,88,74,1414,32,71,79,139,451,139,104,347,91,48,65,35,77,23,91,48,65,35,572
 NJTO-OP1 NJ Organ and Tissue Sharing Network,NJ Organ and Tissue Sharing Network,NJTO,2013,9300,537,160,138,474,6,30,26,88,81,1480,32,69,73,138,474,138,58,416,111,27,80,20,88,12,111,27,80,20,573
 NJTO-OP1 NJ Organ and Tissue Sharing Network,NJ Organ and Tissue Sharing Network,NJTO,2014,9601,519,145,125,441,5,28,24,85,75,1442,31,73,76,125,441,125,38,403,109,16,87,13,91,9,109,16,87,13,574
 NJTO-OP1 NJ Organ and Tissue Sharing Network,NJ Organ and Tissue Sharing Network,NJTO,2015,9778,530,195,171,601,5,37,32,113,100,1467,41,73,77,171,601,171,67,534,145,26,85,15,89,11,145,26,85,15,575
 NJTO-OP1 NJ Organ and Tissue Sharing Network,NJ Organ and Tissue Sharing Network,NJTO,2016,9967,540,218,183,688,5,40,34,127,114,1490,46,68,72,183,688,183,84,604,151,32,83,17,88,12,151,32,83,17,576
 NMOP-OP1 New Mexico Donor Services,New Mexico Donor Services,NMOP,1999,2779,175,,21,66,6,,12,38,35,481,14,,,21,66,21,2,64,20,1,95,5,97,3,20,1,95,5,577
 NMOP-OP1 New Mexico Donor Services,New Mexico Donor Services,NMOP,2000,2709,180,,30,100,7,,17,56,48,496,20,,,30,100,30,2,98,29,1,97,3,98,2,29,1,97,3,578
 NMOP-OP1 New Mexico Donor Services,New Mexico Donor Services,NMOP,2001,2675,152,,19,57,6,,12,37,34,420,14,,,19,57,19,0,57,19,0,100,0,100,0,19,0,100,0,579
 NMOP-OP1 New Mexico Donor Services,New Mexico Donor Services,NMOP,2002,2767,185,,21,62,7,,11,33,32,510,12,,,21,62,21,2,60,20,1,95,5,97,3,20,1,95,5,580
 NMOP-OP1 New Mexico Donor Services,New Mexico Donor Services,NMOP,2003,2766,170,,21,74,6,,12,44,39,468,16,,,21,74,21,2,72,20,1,95,5,97,3,20,1,95,5,581
 NMOP-OP1 New Mexico Donor Services,New Mexico Donor Services,NMOP,2004,2650,176,,34,110,7,,19,62,51,483,23,,,34,110,34,0,110,34,0,100,0,100,0,34,0,100,0,582
 NMOP-OP1 New Mexico Donor Services,New Mexico Donor Services,NMOP,2005,2656,185,,41,137,7,,22,74,66,508,27,,,41,137,41,0,137,41,0,100,0,100,0,41,0,100,0,583
 NMOP-OP1 New Mexico Donor Services,New Mexico Donor Services,NMOP,2006,2719,177,,34,112,7,,19,63,58,480,23,,,34,112,34,0,112,34,0,100,0,100,0,34,0,100,0,584
 NMOP-OP1 New Mexico Donor Services,New Mexico Donor Services,NMOP,2007,2764,198,,38,135,7,,19,68,60,541,25,,,38,135,38,10,125,33,5,87,13,93,7,33,5,87,13,585
 NMOP-OP1 New Mexico Donor Services,New Mexico Donor Services,NMOP,2008,2820,199,50,42,138,7,25,21,69,58,543,25,,,42,138,42,15,123,35,7,83,17,89,11,35,7,83,17,586
 NMOP-OP1 New Mexico Donor Services,New Mexico Donor Services,NMOP,2009,2709,193,68,51,171,7,35,26,89,78,524,33,,,51,171,51,5,166,49,2,96,4,97,3,49,2,96,4,587
 NMOP-OP1 New Mexico Donor Services,New Mexico Donor Services,NMOP,2010,2680,191,48,41,151,7,25,22,79,71,518,29,,,41,151,41,6,145,39,2,95,5,96,4,39,2,95,5,588
 NMOP-OP1 New Mexico Donor Services,New Mexico Donor Services,NMOP,2011,2636,206,56,46,149,8,27,22,73,67,556,27,75,77,46,149,46,7,142,43,3,93,7,95,5,43,3,93,7,589
 NMOP-OP1 New Mexico Donor Services,New Mexico Donor Services,NMOP,2012,2751,207,35,34,106,8,17,16,51,43,561,19,83,85,34,106,34,10,96,29,5,85,15,91,9,29,5,85,15,590
 NMOP-OP1 New Mexico Donor Services,New Mexico Donor Services,NMOP,2013,2672,195,41,36,112,7,21,18,57,47,533,21,73,77,36,112,36,12,100,30,6,83,17,89,11,30,6,83,17,591
 NMOP-OP1 New Mexico Donor Services,New Mexico Donor Services,NMOP,2014,2883,229,62,54,175,8,27,24,76,66,625,28,81,82,54,175,54,8,167,51,3,94,6,95,5,51,3,94,6,592
 NMOP-OP1 New Mexico Donor Services,New Mexico Donor Services,NMOP,2015,2739,186,59,48,147,7,32,26,79,71,505,29,68,72,48,147,48,17,130,40,8,83,17,88,12,40,8,83,17,593
 NMOP-OP1 New Mexico Donor Services,New Mexico Donor Services,NMOP,2016,2909,202,55,56,174,7,27,28,86,76,551,32,75,80,56,174,56,29,145,43,13,77,23,83,17,43,13,77,23,594
 NVLV-OP1 Nevada Donor Network,Nevada Donor Network,NVLV,1999,3189,151,,33,111,5,,22,73,73,422,26,,,33,111,33,0,111,33,0,100,0,100,0,33,0,100,0,595
 NVLV-OP1 Nevada Donor Network,Nevada Donor Network,NVLV,2000,3209,144,,31,97,4,,22,68,59,402,24,,,31,97,31,0,94,30,0,97,0,97,0,30,0,97,0,596
 NVLV-OP1 Nevada Donor Network,Nevada Donor Network,NVLV,2001,3289,141,,27,95,4,,19,67,62,398,24,,,27,95,27,0,95,27,0,100,0,100,0,27,0,100,0,597
 NVLV-OP1 Nevada Donor Network,Nevada Donor Network,NVLV,2002,3300,160,,33,131,5,,21,82,74,444,30,,,33,131,33,0,131,33,0,100,0,100,0,33,0,100,0,598
 NVLV-OP1 Nevada Donor Network,Nevada Donor Network,NVLV,2003,3361,159,,45,119,5,,28,75,67,441,27,,,45,119,45,0,119,45,0,100,0,100,0,45,0,100,0,599
 NVLV-OP1 Nevada Donor Network,Nevada Donor Network,NVLV,2004,3368,184,,56,193,5,,30,105,101,509,38,,,56,193,56,0,193,56,0,100,0,100,0,56,0,100,0,600
 NVLV-OP1 Nevada Donor Network,Nevada Donor Network,NVLV,2005,3704,183,,49,167,5,,27,91,88,510,33,,,49,167,49,3,164,48,1,98,2,98,2,48,1,98,2,601
 NVLV-OP1 Nevada Donor Network,Nevada Donor Network,NVLV,2006,3645,160,,45,136,4,,28,85,80,442,31,,,45,136,45,0,136,45,0,100,0,100,0,45,0,100,0,602
 NVLV-OP1 Nevada Donor Network,Nevada Donor Network,NVLV,2007,3600,163,,60,189,5,,37,116,106,451,42,,,60,189,60,1,188,59,1,98,2,99,1,59,1,98,2,603
 NVLV-OP1 Nevada Donor Network,Nevada Donor Network,NVLV,2008,2869,174,97,61,218,6,56,35,125,114,474,46,,,61,218,61,0,218,61,0,100,0,100,0,61,0,100,0,604
 NVLV-OP1 Nevada Donor Network,Nevada Donor Network,NVLV,2009,2892,171,62,43,152,6,36,25,89,77,466,33,,,43,152,43,6,146,41,2,95,5,96,4,41,2,95,5,605
 NVLV-OP1 Nevada Donor Network,Nevada Donor Network,NVLV,2010,2685,163,66,50,184,6,41,31,113,108,446,41,,,50,184,50,0,184,50,0,100,0,100,0,50,0,100,0,606
 NVLV-OP1 Nevada Donor Network,Nevada Donor Network,NVLV,2011,3136,297,83,53,182,9,28,18,61,58,796,23,63,63,53,182,53,3,179,52,1,98,2,98,2,52,1,98,2,607
 NVLV-OP1 Nevada Donor Network,Nevada Donor Network,NVLV,2012,2513,143,99,75,274,6,69,52,191,164,390,70,65,68,75,274,75,13,261,69,6,92,8,95,5,69,6,92,8,608
 NVLV-OP1 Nevada Donor Network,Nevada Donor Network,NVLV,2013,2769,194,144,104,381,7,74,54,196,158,530,72,65,67,104,381,104,5,376,102,2,98,2,99,1,102,2,98,2,609
 NVLV-OP1 Nevada Donor Network,Nevada Donor Network,NVLV,2014,2989,171,104,98,352,6,61,57,205,166,472,75,78,81,98,352,98,23,329,89,9,91,9,93,7,89,9,91,9,610
 NVLV-OP1 Nevada Donor Network,Nevada Donor Network,NVLV,2015,3104,187,119,106,378,6,64,57,202,172,513,74,72,76,106,378,106,49,329,87,19,82,18,87,13,87,19,82,18,611
 NVLV-OP1 Nevada Donor Network,Nevada Donor Network,NVLV,2016,3306,205,133,107,405,6,65,52,198,177,561,72,68,72,107,405,107,27,378,96,11,90,10,93,7,96,11,90,10,612
 NYAP-OP1 Ctr for Donation and Transplant,Ctr for Donation and Transplant,NYAP,1999,5393,215,,41,144,4,,19,67,59,612,24,,,41,144,41,0,144,41,0,100,0,100,0,41,0,100,0,613
 NYAP-OP1 Ctr for Donation and Transplant,Ctr for Donation and Transplant,NYAP,2000,5265,225,,55,181,4,,24,80,65,635,29,,,55,181,55,2,179,54,1,98,2,99,1,54,1,98,2,614
 NYAP-OP1 Ctr for Donation and Transplant,Ctr for Donation and Transplant,NYAP,2001,5447,239,,45,181,4,,19,76,62,677,27,,,45,181,45,0,181,45,0,100,0,100,0,45,0,100,0,615
 NYAP-OP1 Ctr for Donation and Transplant,Ctr for Donation and Transplant,NYAP,2002,5215,203,,47,164,4,,23,81,66,572,29,,,47,164,47,0,164,47,0,100,0,100,0,47,0,100,0,616
 NYAP-OP1 Ctr for Donation and Transplant,Ctr for Donation and Transplant,NYAP,2003,5086,210,,51,173,4,,24,82,74,588,29,,,51,173,51,0,173,51,0,100,0,100,0,51,0,100,0,617
 NYAP-OP1 Ctr for Donation and Transplant,Ctr for Donation and Transplant,NYAP,2004,4955,217,,48,151,4,,22,70,62,613,25,,,48,151,48,0,151,48,0,100,0,100,0,48,0,100,0,618
 NYAP-OP1 Ctr for Donation and Transplant,Ctr for Donation and Transplant,NYAP,2005,4874,205,,52,170,4,,25,83,76,572,30,,,52,170,52,7,163,50,2,96,4,96,4,50,2,96,4,619
 NYAP-OP1 Ctr for Donation and Transplant,Ctr for Donation and Transplant,NYAP,2006,4880,234,,51,165,5,,22,71,63,648,25,,,51,165,51,11,154,46,5,90,10,93,7,46,5,90,10,620
 NYAP-OP1 Ctr for Donation and Transplant,Ctr for Donation and Transplant,NYAP,2007,4904,212,,41,125,4,,19,59,46,593,21,,,41,125,41,19,106,34,7,83,17,85,15,34,7,83,17,621
 NYAP-OP1 Ctr for Donation and Transplant,Ctr for Donation and Transplant,NYAP,2008,4791,198,44,47,148,4,22,24,75,61,556,27,,,47,148,47,29,119,37,10,79,21,80,20,37,10,79,21,622
 NYAP-OP1 Ctr for Donation and Transplant,Ctr for Donation and Transplant,NYAP,2009,4879,232,45,44,156,5,19,19,67,56,645,24,,,44,156,44,11,145,39,5,89,11,93,7,39,5,89,11,623
 NYAP-OP1 Ctr for Donation and Transplant,Ctr for Donation and Transplant,NYAP,2010,4627,219,42,43,161,5,19,20,73,62,617,26,,,43,161,43,24,137,35,8,81,19,85,15,35,8,81,19,624
 NYAP-OP1 Ctr for Donation and Transplant,Ctr for Donation and Transplant,NYAP,2011,4845,230,43,41,133,5,19,18,58,52,640,21,72,77,41,133,41,13,120,35,6,85,15,90,10,35,6,85,15,625
 NYAP-OP1 Ctr for Donation and Transplant,Ctr for Donation and Transplant,NYAP,2012,4740,239,50,49,153,5,21,21,64,52,669,23,66,74,49,153,49,13,140,43,6,88,12,92,8,43,6,88,12,626
 NYAP-OP1 Ctr for Donation and Transplant,Ctr for Donation and Transplant,NYAP,2013,4933,246,59,52,157,5,24,21,64,53,680,23,64,71,52,157,52,21,136,42,10,81,19,87,13,42,10,81,19,627
 NYAP-OP1 Ctr for Donation and Transplant,Ctr for Donation and Transplant,NYAP,2014,4770,231,53,58,160,5,23,25,69,62,644,25,70,78,58,160,58,33,127,42,16,72,28,79,21,42,16,72,28,628
 NYAP-OP1 Ctr for Donation and Transplant,Ctr for Donation and Transplant,NYAP,2015,4869,229,44,53,153,5,19,23,67,61,642,24,66,78,53,153,53,48,105,35,18,66,34,69,31,35,18,66,34,629
 NYAP-OP1 Ctr for Donation and Transplant,Ctr for Donation and Transplant,NYAP,2016,4893,268,49,61,183,5,18,23,68,60,747,24,78,85,61,183,61,47,136,42,19,69,31,74,26,42,19,69,31,630
 NYFL-IO1 Finger Lakes Donor Recovery Network,Finger Lakes Donor Recovery Network,NYFL,1999,4417,194,,42,150,4,,22,77,71,549,27,,,42,150,42,5,145,40,2,95,5,97,3,40,2,95,5,631
 NYFL-IO1 Finger Lakes Donor Recovery Network,Finger Lakes Donor Recovery Network,NYFL,2000,4217,187,,36,140,4,,19,75,62,529,26,,,36,140,36,7,133,33,3,92,8,95,5,33,3,92,8,632
 NYFL-IO1 Finger Lakes Donor Recovery Network,Finger Lakes Donor Recovery Network,NYFL,2001,4045,185,,49,164,5,,27,89,74,519,32,,,49,164,49,12,152,44,5,90,10,93,7,44,5,90,10,633
 NYFL-IO1 Finger Lakes Donor Recovery Network,Finger Lakes Donor Recovery Network,NYFL,2002,4126,157,,30,91,4,,19,58,49,447,20,,,30,91,30,3,88,29,1,97,3,97,3,29,1,97,3,634
 NYFL-IO1 Finger Lakes Donor Recovery Network,Finger Lakes Donor Recovery Network,NYFL,2003,4034,187,,43,153,5,,23,82,70,520,29,,,43,153,43,7,146,40,3,93,7,95,5,40,3,93,7,635
 NYFL-IO1 Finger Lakes Donor Recovery Network,Finger Lakes Donor Recovery Network,NYFL,2004,3970,188,,53,180,5,,28,96,83,524,34,,,53,180,53,29,151,42,11,79,21,84,16,42,11,79,21,636
 NYFL-IO1 Finger Lakes Donor Recovery Network,Finger Lakes Donor Recovery Network,NYFL,2005,3979,162,,53,189,4,,33,117,102,453,42,,,53,189,53,34,155,40,13,75,25,82,18,40,13,75,25,637
 NYFL-IO1 Finger Lakes Donor Recovery Network,Finger Lakes Donor Recovery Network,NYFL,2006,3894,158,,43,145,4,,27,92,75,446,32,,,43,145,43,24,121,34,9,79,21,83,17,34,9,79,21,638
 NYFL-IO1 Finger Lakes Donor Recovery Network,Finger Lakes Donor Recovery Network,NYFL,2007,3900,184,,49,172,5,,27,93,72,511,34,,,49,172,49,24,148,41,8,84,16,86,14,41,8,84,16,639
 NYFL-IO1 Finger Lakes Donor Recovery Network,Finger Lakes Donor Recovery Network,NYFL,2008,3858,185,50,39,123,5,27,21,66,59,516,24,,,39,123,39,11,112,35,4,90,10,91,9,35,4,90,10,640
 NYFL-IO1 Finger Lakes Donor Recovery Network,Finger Lakes Donor Recovery Network,NYFL,2009,3889,195,58,48,144,5,30,25,74,60,543,27,,,48,144,48,24,120,36,12,75,25,83,17,36,12,75,25,641
 NYFL-IO1 Finger Lakes Donor Recovery Network,Finger Lakes Donor Recovery Network,NYFL,2010,3919,204,52,51,157,5,26,25,77,66,566,28,,,51,157,51,39,118,35,16,69,31,75,25,35,16,69,31,642
 NYFL-IO1 Finger Lakes Donor Recovery Network,Finger Lakes Donor Recovery Network,NYFL,2011,3968,220,40,45,140,6,18,20,64,51,612,23,65,76,45,140,45,45,95,28,17,62,38,68,32,28,17,62,38,643
 NYFL-IO1 Finger Lakes Donor Recovery Network,Finger Lakes Donor Recovery Network,NYFL,2012,4008,216,36,38,124,5,17,18,57,56,595,21,78,83,38,124,38,20,104,29,9,76,24,84,16,29,9,76,24,644
 NYFL-IO1 Finger Lakes Donor Recovery Network,Finger Lakes Donor Recovery Network,NYFL,2013,3905,208,45,48,139,5,22,23,67,57,574,24,64,75,48,139,48,42,97,31,17,65,35,70,30,31,17,65,35,645
 NYFL-IO1 Finger Lakes Donor Recovery Network,Finger Lakes Donor Recovery Network,NYFL,2014,4191,217,39,40,116,5,18,18,53,50,606,19,72,78,40,116,40,21,95,29,11,73,28,82,18,29,11,73,28,646
 NYFL-IO1 Finger Lakes Donor Recovery Network,Finger Lakes Donor Recovery Network,NYFL,2015,4169,211,47,50,145,5,22,24,69,65,593,24,68,77,50,145,50,35,110,33,17,66,34,76,24,33,17,66,34,647
 NYFL-IO1 Finger Lakes Donor Recovery Network,Finger Lakes Donor Recovery Network,NYFL,2016,4314,235,55,50,168,5,23,21,71,62,653,26,64,71,50,168,50,31,137,37,13,74,26,82,18,37,13,74,26,648
 NYRT-OP1 LiveOnNY,LiveOnNY,NYRT,1999,26063,965,,213,673,4,,22,70,58,2684,25,,,213,673,213,0,673,213,0,100,0,100,0,213,0,100,0,649
 NYRT-OP1 LiveOnNY,LiveOnNY,NYRT,2000,25054,876,,204,625,3,,23,71,60,2438,26,,,204,625,204,0,625,204,0,100,0,100,0,204,0,100,0,650
 NYRT-OP1 LiveOnNY,LiveOnNY,NYRT,2001,24556,894,,199,629,4,,22,70,61,2488,25,,,199,629,199,0,629,199,0,100,0,100,0,199,0,100,0,651
 NYRT-OP1 LiveOnNY,LiveOnNY,NYRT,2002,24352,850,,205,663,3,,24,78,71,2367,28,,,205,663,205,6,657,203,2,99,1,99,1,203,2,99,1,652
 NYRT-OP1 LiveOnNY,LiveOnNY,NYRT,2003,23385,843,,217,631,4,,26,75,68,2342,27,,,217,631,217,6,625,215,2,99,1,99,1,215,2,99,1,653
 NYRT-OP1 LiveOnNY,LiveOnNY,NYRT,2004,22189,825,,262,735,4,,32,89,79,2283,32,,,262,735,262,16,719,256,6,98,2,98,2,256,6,98,2,654
 NYRT-OP1 LiveOnNY,LiveOnNY,NYRT,2005,21334,777,,261,778,4,,34,100,88,2155,36,,,261,778,261,44,734,244,17,93,7,94,6,244,17,93,7,655
 NYRT-OP1 LiveOnNY,LiveOnNY,NYRT,2006,20498,849,,319,984,4,,38,116,96,2341,42,,,319,984,319,40,944,304,15,95,5,96,4,304,15,95,5,656
 NYRT-OP1 LiveOnNY,LiveOnNY,NYRT,2007,20356,792,,322,990,4,,41,125,99,2188,45,,,322,990,322,56,934,301,21,93,7,94,6,301,21,93,7,657
 NYRT-OP1 LiveOnNY,LiveOnNY,NYRT,2008,20820,862,430,251,777,4,50,29,90,75,2372,33,,,251,777,251,19,758,243,8,97,3,98,2,243,8,97,3,658
 NYRT-OP1 LiveOnNY,LiveOnNY,NYRT,2009,19732,835,409,285,871,4,49,34,104,89,2297,38,,,285,871,285,39,832,270,15,95,5,96,4,270,15,95,5,659
 NYRT-OP1 LiveOnNY,LiveOnNY,NYRT,2010,19086,855,354,242,748,4,41,28,88,73,2357,32,,,242,748,242,53,695,223,19,92,8,93,7,223,19,92,8,660
 NYRT-OP1 LiveOnNY,LiveOnNY,NYRT,2011,18999,886,356,264,791,5,40,30,89,76,2447,32,59,64,264,791,264,41,750,245,19,93,7,95,5,245,19,93,7,661
 NYRT-OP1 LiveOnNY,LiveOnNY,NYRT,2012,18647,892,319,234,701,5,36,26,79,70,2460,28,61,65,234,701,234,45,656,215,19,92,8,94,6,215,19,92,8,662
 NYRT-OP1 LiveOnNY,LiveOnNY,NYRT,2013,18676,884,353,223,685,5,40,25,77,68,2435,28,53,57,223,685,223,35,650,209,14,94,6,95,5,209,14,94,6,663
 NYRT-OP1 LiveOnNY,LiveOnNY,NYRT,2014,18342,857,298,235,692,5,35,27,81,71,2358,29,68,71,235,692,235,46,646,217,18,92,8,93,7,217,18,92,8,664
 NYRT-OP1 LiveOnNY,LiveOnNY,NYRT,2015,18098,852,293,220,687,5,34,26,81,72,2353,29,61,66,220,687,220,69,618,194,26,88,12,90,10,194,26,88,12,665
 NYRT-OP1 LiveOnNY,LiveOnNY,NYRT,2016,18757,916,393,271,834,5,43,30,91,82,2535,33,53,59,271,834,271,110,724,229,42,85,15,87,13,229,42,85,15,666
 NYWN-OP1 Upstate NY Transplant Svcs,Upstate NY Transplant Svcs,NYWN,1999,3284,138,,47,174,4,,34,126,116,393,44,,,47,174,47,0,174,47,0,100,0,100,0,47,0,100,0,667
 NYWN-OP1 Upstate NY Transplant Svcs,Upstate NY Transplant Svcs,NYWN,2000,3286,154,,49,183,5,,32,119,106,441,42,,,49,183,49,0,183,49,0,100,0,100,0,49,0,100,0,668
 NYWN-OP1 Upstate NY Transplant Svcs,Upstate NY Transplant Svcs,NYWN,2001,3024,149,,43,157,5,,29,105,89,426,37,,,43,157,43,0,157,43,0,100,0,100,0,43,0,100,0,669
 NYWN-OP1 Upstate NY Transplant Svcs,Upstate NY Transplant Svcs,NYWN,2002,3116,142,,45,158,5,,32,112,104,402,39,,,45,158,45,3,155,44,1,98,2,98,2,44,1,98,2,670
 NYWN-OP1 Upstate NY Transplant Svcs,Upstate NY Transplant Svcs,NYWN,2003,2939,131,,42,136,4,,32,104,87,374,36,,,42,136,42,0,136,42,0,100,0,100,0,42,0,100,0,671
 NYWN-OP1 Upstate NY Transplant Svcs,Upstate NY Transplant Svcs,NYWN,2004,2766,119,,35,117,4,,29,98,84,333,35,,,35,117,35,7,110,32,3,91,9,94,6,32,3,91,9,672
 NYWN-OP1 Upstate NY Transplant Svcs,Upstate NY Transplant Svcs,NYWN,2005,2794,126,,58,185,5,,46,146,120,356,52,,,58,185,58,10,175,54,4,93,7,95,5,54,4,93,7,673
 NYWN-OP1 Upstate NY Transplant Svcs,Upstate NY Transplant Svcs,NYWN,2006,2653,126,,55,178,5,,44,142,115,351,51,,,55,178,55,6,172,52,3,95,5,97,3,52,3,95,5,674
 NYWN-OP1 Upstate NY Transplant Svcs,Upstate NY Transplant Svcs,NYWN,2007,2689,140,,55,181,5,,39,129,99,386,47,,,55,181,55,8,173,52,3,95,5,96,4,52,3,95,5,675
 NYWN-OP1 Upstate NY Transplant Svcs,Upstate NY Transplant Svcs,NYWN,2008,2506,125,32,36,129,5,26,29,103,91,350,37,,,36,129,36,16,113,30,6,83,17,88,12,30,6,83,17,676
 NYWN-OP1 Upstate NY Transplant Svcs,Upstate NY Transplant Svcs,NYWN,2009,2587,133,33,46,145,5,25,35,109,87,368,39,,,46,145,46,34,111,33,13,72,28,77,23,33,13,72,28,677
 NYWN-OP1 Upstate NY Transplant Svcs,Upstate NY Transplant Svcs,NYWN,2010,2523,131,39,43,137,5,30,33,105,89,366,37,,,43,137,43,11,126,38,5,88,12,92,8,38,5,88,12,678
 NYWN-OP1 Upstate NY Transplant Svcs,Upstate NY Transplant Svcs,NYWN,2011,2550,128,34,43,139,5,27,34,109,95,358,39,82,88,43,139,43,16,123,35,8,81,19,88,12,35,8,81,19,679
 NYWN-OP1 Upstate NY Transplant Svcs,Upstate NY Transplant Svcs,NYWN,2012,2489,131,23,37,115,5,18,28,88,72,369,31,83,90,37,115,37,22,93,28,9,76,24,81,19,28,9,76,24,680
 NYWN-OP1 Upstate NY Transplant Svcs,Upstate NY Transplant Svcs,NYWN,2013,2543,137,30,33,93,5,22,24,68,54,384,24,50,69,33,93,33,29,64,19,14,58,42,69,31,19,14,58,42,681
 NYWN-OP1 Upstate NY Transplant Svcs,Upstate NY Transplant Svcs,NYWN,2014,2609,136,40,46,166,5,29,34,122,106,378,44,75,82,46,166,46,31,135,32,14,70,30,81,19,32,14,70,30,682
 NYWN-OP1 Upstate NY Transplant Svcs,Upstate NY Transplant Svcs,NYWN,2015,2573,138,41,46,139,5,30,33,101,82,382,36,71,79,46,139,46,40,99,29,17,63,37,71,29,29,17,63,37,683
 NYWN-OP1 Upstate NY Transplant Svcs,Upstate NY Transplant Svcs,NYWN,2016,2694,164,40,61,181,6,24,37,110,85,453,40,88,92,61,181,61,46,135,38,23,62,38,75,25,38,23,62,38,684
 OHLB-OP1 LifeBanc,LifeBanc,OHLB,1999,7617,396,,65,250,5,,16,63,59,1120,22,,,65,250,65,0,248,64,0,98,0,99,0,64,0,98,0,685
 OHLB-OP1 LifeBanc,LifeBanc,OHLB,2000,7209,363,,83,324,5,,23,89,81,1029,31,,,83,324,83,0,324,83,0,100,0,100,0,83,0,100,0,686
 OHLB-OP1 LifeBanc,LifeBanc,OHLB,2001,6999,371,,89,315,5,,24,85,72,1042,30,,,89,315,89,0,315,89,0,100,0,100,0,89,0,100,0,687
 OHLB-OP1 LifeBanc,LifeBanc,OHLB,2002,6918,360,,67,245,5,,19,68,61,1009,24,,,67,245,67,0,245,67,0,100,0,100,0,67,0,100,0,688
 OHLB-OP1 LifeBanc,LifeBanc,OHLB,2003,6612,340,,72,270,5,,21,80,68,946,29,,,72,270,72,0,270,72,0,100,0,100,0,72,0,100,0,689
 OHLB-OP1 LifeBanc,LifeBanc,OHLB,2004,6567,369,,89,315,6,,24,85,71,1025,31,,,89,315,89,0,315,89,0,100,0,100,0,89,0,100,0,690
 OHLB-OP1 LifeBanc,LifeBanc,OHLB,2005,6593,350,,74,268,5,,21,77,67,974,28,,,74,268,74,3,265,73,1,99,1,99,1,73,1,99,1,691
 OHLB-OP1 LifeBanc,LifeBanc,OHLB,2006,6399,361,,111,386,6,,31,107,91,1004,38,,,111,386,111,9,377,108,3,97,3,98,2,108,3,97,3,692
 OHLB-OP1 LifeBanc,LifeBanc,OHLB,2007,6314,383,,100,407,6,,26,106,91,1056,39,,,100,407,100,19,388,94,6,94,6,95,5,94,6,94,6,693
 OHLB-OP1 LifeBanc,LifeBanc,OHLB,2008,6421,406,123,111,382,6,30,27,94,76,1118,34,,,111,382,111,23,359,102,9,92,8,94,6,102,9,92,8,694
 OHLB-OP1 LifeBanc,LifeBanc,OHLB,2009,6346,376,137,116,479,6,36,31,127,106,1039,46,,,116,479,116,28,451,106,10,91,9,94,6,106,10,91,9,695
 OHLB-OP1 LifeBanc,LifeBanc,OHLB,2010,6186,387,136,118,470,6,35,30,121,105,1069,44,,,118,470,118,22,448,109,9,92,8,95,5,109,9,92,8,696
 OHLB-OP1 LifeBanc,LifeBanc,OHLB,2011,6315,385,122,112,413,6,32,29,107,94,1062,39,73,77,112,413,112,38,375,98,14,88,13,91,9,98,14,88,13,697
 OHLB-OP1 LifeBanc,LifeBanc,OHLB,2012,6133,381,119,118,413,6,31,31,108,94,1049,39,73,79,118,413,118,51,362,97,21,82,18,88,12,97,21,82,18,698
 OHLB-OP1 LifeBanc,LifeBanc,OHLB,2013,6140,364,112,111,420,6,31,31,116,105,998,42,74,79,111,420,111,33,387,97,14,87,13,92,8,97,14,87,13,699
 OHLB-OP1 LifeBanc,LifeBanc,OHLB,2014,6185,392,112,119,423,6,29,30,108,89,1080,39,82,86,119,423,119,38,385,106,13,89,11,91,9,106,13,89,11,700
 OHLB-OP1 LifeBanc,LifeBanc,OHLB,2015,6423,417,129,135,479,6,31,32,115,99,1152,42,67,76,135,479,135,71,408,105,30,78,22,85,15,105,30,78,22,701
 OHLB-OP1 LifeBanc,LifeBanc,OHLB,2016,6548,451,147,150,515,7,33,33,114,96,1237,42,72,79,150,515,150,80,435,121,29,81,19,84,16,121,29,81,19,702
 OHLC-OP1 Life Connection of Ohio,Life Connection of Ohio,OHLC,1999,4028,217,,56,185,5,,26,85,76,614,30,,,56,185,56,0,185,56,0,100,0,100,0,56,0,100,0,703
 OHLC-OP1 Life Connection of Ohio,Life Connection of Ohio,OHLC,2000,4002,206,,47,181,5,,23,88,80,579,31,,,47,181,47,3,178,46,1,98,2,98,2,46,1,98,2,704
 OHLC-OP1 Life Connection of Ohio,Life Connection of Ohio,OHLC,2001,3811,207,,46,177,5,,22,85,79,578,31,,,46,177,46,2,175,45,1,98,2,99,1,45,1,98,2,705
 OHLC-OP1 Life Connection of Ohio,Life Connection of Ohio,OHLC,2002,3664,197,,50,179,5,,25,91,84,550,33,,,50,179,50,0,179,50,0,100,0,100,0,50,0,100,0,706
 OHLC-OP1 Life Connection of Ohio,Life Connection of Ohio,OHLC,2003,3554,179,,58,220,5,,32,123,115,496,44,,,58,220,58,0,220,58,0,100,0,100,0,58,0,100,0,707
 OHLC-OP1 Life Connection of Ohio,Life Connection of Ohio,OHLC,2004,3394,188,,52,206,6,,28,110,102,521,40,,,52,206,52,2,204,51,1,98,2,99,1,51,1,98,2,708
 OHLC-OP1 Life Connection of Ohio,Life Connection of Ohio,OHLC,2005,3318,204,,45,178,6,,22,87,82,563,32,,,45,178,45,2,176,44,1,98,2,99,1,44,1,98,2,709
 OHLC-OP1 Life Connection of Ohio,Life Connection of Ohio,OHLC,2006,3274,198,,46,166,6,,23,84,78,548,30,,,46,166,46,5,161,44,2,96,4,97,3,44,2,96,4,710
 OHLC-OP1 Life Connection of Ohio,Life Connection of Ohio,OHLC,2007,3175,197,,55,212,6,,28,108,101,541,39,,,55,212,55,7,205,52,3,95,5,97,3,52,3,95,5,711
 OHLC-OP1 Life Connection of Ohio,Life Connection of Ohio,OHLC,2008,3128,187,78,63,228,6,42,34,122,117,516,44,,,63,228,63,12,216,58,5,92,8,95,5,58,5,92,8,712
 OHLC-OP1 Life Connection of Ohio,Life Connection of Ohio,OHLC,2009,3082,187,59,46,160,6,32,25,85,77,514,31,,,46,160,46,16,144,40,6,87,13,90,10,40,6,87,13,713
 OHLC-OP1 Life Connection of Ohio,Life Connection of Ohio,OHLC,2010,3088,208,83,65,260,7,40,31,125,110,571,46,,,65,260,65,18,242,58,7,89,11,93,7,58,7,89,11,714
 OHLC-OP1 Life Connection of Ohio,Life Connection of Ohio,OHLC,2011,3214,198,63,46,175,6,32,23,88,75,547,32,71,72,46,175,46,4,171,45,1,98,2,98,2,45,1,98,2,715
 OHLC-OP1 Life Connection of Ohio,Life Connection of Ohio,OHLC,2012,3105,195,57,44,155,6,29,23,79,75,541,29,72,73,44,155,44,7,148,41,3,93,7,95,5,41,3,93,7,716
 OHLC-OP1 Life Connection of Ohio,Life Connection of Ohio,OHLC,2013,3262,207,73,62,226,6,35,30,109,101,569,40,68,73,62,226,62,29,197,50,12,81,19,87,13,50,12,81,19,717
 OHLC-OP1 Life Connection of Ohio,Life Connection of Ohio,OHLC,2014,3203,211,83,67,259,7,39,32,123,113,582,45,78,79,67,259,67,7,252,65,2,97,3,97,3,65,2,97,3,718
 OHLC-OP1 Life Connection of Ohio,Life Connection of Ohio,OHLC,2015,3240,206,69,70,231,6,34,34,112,99,565,41,81,84,70,231,70,29,202,58,12,83,17,87,13,58,12,83,17,719
 OHLC-OP1 Life Connection of Ohio,Life Connection of Ohio,OHLC,2016,3334,226,70,50,208,7,31,22,92,84,616,34,67,68,50,208,50,4,204,48,2,96,4,98,2,48,2,96,4,720
 OHLP-OP1 Lifeline of Ohio,Lifeline of Ohio,OHLP,1999,5783,254,,64,265,4,,25,104,96,725,37,,,64,265,64,0,265,64,0,100,0,100,0,64,0,100,0,721
 OHLP-OP1 Lifeline of Ohio,Lifeline of Ohio,OHLP,2000,5739,277,,81,323,5,,29,117,105,778,42,,,81,323,81,2,321,80,1,99,1,99,1,80,1,99,1,722
 OHLP-OP1 Lifeline of Ohio,Lifeline of Ohio,OHLP,2001,5666,261,,65,253,5,,25,97,91,735,34,,,65,253,65,0,253,65,0,100,0,100,0,65,0,100,0,723
 OHLP-OP1 Lifeline of Ohio,Lifeline of Ohio,OHLP,2002,5585,269,,70,275,5,,26,102,92,756,36,,,70,275,70,0,275,70,0,100,0,100,0,70,0,100,0,724
 OHLP-OP1 Lifeline of Ohio,Lifeline of Ohio,OHLP,2003,5542,223,,63,257,4,,28,115,104,631,41,,,63,257,63,0,257,63,0,100,0,100,0,63,0,100,0,725
 OHLP-OP1 Lifeline of Ohio,Lifeline of Ohio,OHLP,2004,5341,265,,86,311,5,,32,117,99,742,42,,,86,311,86,0,311,86,0,100,0,100,0,86,0,100,0,726
 OHLP-OP1 Lifeline of Ohio,Lifeline of Ohio,OHLP,2005,5419,263,,79,312,5,,30,119,102,733,43,,,79,312,79,3,309,78,1,99,1,99,1,78,1,99,1,727
 OHLP-OP1 Lifeline of Ohio,Lifeline of Ohio,OHLP,2006,5339,266,,107,387,5,,40,145,128,737,53,,,107,387,107,19,368,100,7,93,7,95,5,100,7,93,7,728
 OHLP-OP1 Lifeline of Ohio,Lifeline of Ohio,OHLP,2007,5264,302,,97,363,6,,32,120,102,832,44,,,97,363,97,11,352,93,4,96,4,97,3,93,4,96,4,729
 OHLP-OP1 Lifeline of Ohio,Lifeline of Ohio,OHLP,2008,5334,302,111,100,351,6,37,33,116,101,838,42,,,100,351,100,31,320,88,12,88,12,91,9,88,12,88,12,730
 OHLP-OP1 Lifeline of Ohio,Lifeline of Ohio,OHLP,2009,5175,269,97,90,341,5,36,34,127,109,743,46,,,90,341,90,24,317,82,8,91,9,93,7,82,8,91,9,731
 OHLP-OP1 Lifeline of Ohio,Lifeline of Ohio,OHLP,2010,5095,315,100,82,319,6,32,26,101,86,869,37,,,82,319,82,8,311,79,3,96,4,97,3,79,3,96,4,732
 OHLP-OP1 Lifeline of Ohio,Lifeline of Ohio,OHLP,2011,5205,344,100,95,352,7,29,28,102,93,942,37,84,86,95,352,95,17,335,87,8,92,8,95,5,87,8,92,8,733
 OHLP-OP1 Lifeline of Ohio,Lifeline of Ohio,OHLP,2012,5267,330,108,88,330,6,33,27,100,92,908,36,71,74,88,330,88,23,307,78,10,89,11,93,7,78,10,89,11,734
 OHLP-OP1 Lifeline of Ohio,Lifeline of Ohio,OHLP,2013,5224,337,88,81,294,6,26,24,87,80,928,32,72,76,81,294,81,32,262,66,15,81,19,89,11,66,15,81,19,735
 OHLP-OP1 Lifeline of Ohio,Lifeline of Ohio,OHLP,2014,5311,323,99,84,302,6,31,26,93,85,899,34,74,76,84,302,84,23,279,74,10,88,12,92,8,74,10,88,12,736
 OHLP-OP1 Lifeline of Ohio,Lifeline of Ohio,OHLP,2015,5616,354,93,91,316,6,26,26,89,78,974,32,76,81,91,316,91,47,269,73,18,80,20,85,15,73,18,80,20,737
 OHLP-OP1 Lifeline of Ohio,Lifeline of Ohio,OHLP,2016,5748,368,105,93,337,6,29,25,92,81,1008,33,73,77,93,337,93,41,296,77,16,83,17,88,12,77,16,83,17,738
 OHOV-OP1 LifeCenter Organ Donor Network,LifeCenter Organ Donor Network,OHOV,1999,3736,169,,41,141,5,,24,83,74,479,29,,,41,141,41,5,136,39,2,95,5,96,4,39,2,95,5,739
 OHOV-OP1 LifeCenter Organ Donor Network,LifeCenter Organ Donor Network,OHOV,2000,3593,179,,47,168,5,,26,94,77,503,33,,,47,168,47,16,152,39,8,83,17,90,10,39,8,83,17,740
 OHOV-OP1 LifeCenter Organ Donor Network,LifeCenter Organ Donor Network,OHOV,2001,3454,169,,41,140,5,,24,83,68,472,30,,,41,140,41,10,130,36,5,88,12,93,7,36,5,88,12,741
 OHOV-OP1 LifeCenter Organ Donor Network,LifeCenter Organ Donor Network,OHOV,2002,3465,174,,39,143,5,,22,82,75,486,29,,,39,143,39,2,141,38,1,97,3,99,1,38,1,97,3,742
 OHOV-OP1 LifeCenter Organ Donor Network,LifeCenter Organ Donor Network,OHOV,2003,3226,146,,39,132,5,,27,90,66,408,32,,,39,132,39,14,118,33,6,85,15,89,11,33,6,85,15,743
 OHOV-OP1 LifeCenter Organ Donor Network,LifeCenter Organ Donor Network,OHOV,2004,3067,156,,49,174,5,,31,112,105,432,40,,,49,174,49,7,167,46,3,94,6,96,4,46,3,94,6,744
 OHOV-OP1 LifeCenter Organ Donor Network,LifeCenter Organ Donor Network,OHOV,2005,3106,160,,60,219,5,,38,137,112,443,49,,,60,219,60,11,208,55,5,92,8,95,5,55,5,92,8,745
 OHOV-OP1 LifeCenter Organ Donor Network,LifeCenter Organ Donor Network,OHOV,2006,3045,156,,48,164,5,,31,105,89,432,38,,,48,164,48,10,154,44,4,92,8,94,6,44,4,92,8,746
 OHOV-OP1 LifeCenter Organ Donor Network,LifeCenter Organ Donor Network,OHOV,2007,3006,163,,64,221,5,,39,136,117,451,49,,,64,221,64,11,210,59,5,92,8,95,5,59,5,92,8,747
 OHOV-OP1 LifeCenter Organ Donor Network,LifeCenter Organ Donor Network,OHOV,2008,3052,175,52,31,107,6,30,18,61,52,481,22,,,31,107,31,7,100,29,2,94,6,93,7,29,2,94,6,748
 OHOV-OP1 LifeCenter Organ Donor Network,LifeCenter Organ Donor Network,OHOV,2009,3073,162,49,32,124,5,30,20,77,68,447,28,,,32,124,32,11,113,29,3,91,9,91,9,29,3,91,9,749
 OHOV-OP1 LifeCenter Organ Donor Network,LifeCenter Organ Donor Network,OHOV,2010,2797,154,45,38,160,5,29,25,104,95,421,38,,,38,160,38,7,153,35,3,92,8,96,4,35,3,92,8,750
 OHOV-OP1 LifeCenter Organ Donor Network,LifeCenter Organ Donor Network,OHOV,2011,2930,170,41,34,143,6,24,20,84,73,464,31,63,69,34,143,34,12,131,30,4,88,12,92,8,30,4,88,12,751
 OHOV-OP1 LifeCenter Organ Donor Network,LifeCenter Organ Donor Network,OHOV,2012,2743,177,43,47,169,6,24,27,96,85,485,35,86,89,47,169,47,11,158,42,5,89,11,93,7,42,5,89,11,752
 OHOV-OP1 LifeCenter Organ Donor Network,LifeCenter Organ Donor Network,OHOV,2013,2809,185,34,34,120,7,18,18,65,56,507,24,74,79,34,120,34,21,99,26,8,76,24,83,18,26,8,76,24,753
 OHOV-OP1 LifeCenter Organ Donor Network,LifeCenter Organ Donor Network,OHOV,2014,2950,192,51,54,228,7,27,28,118,111,527,43,86,89,54,228,54,24,204,46,8,85,15,89,11,46,8,85,15,754
 OHOV-OP1 LifeCenter Organ Donor Network,LifeCenter Organ Donor Network,OHOV,2015,2963,221,56,56,212,7,25,25,96,88,600,35,79,82,56,212,56,21,191,49,7,88,13,90,10,49,7,88,13,755
 OHOV-OP1 LifeCenter Organ Donor Network,LifeCenter Organ Donor Network,OHOV,2016,2967,237,67,65,233,8,28,27,98,90,641,36,79,82,65,233,65,24,209,57,8,88,12,90,10,57,8,88,12,756
 OKOP-OP1 LifeShare Transplant Donor Svcs of OK,LifeShare Transplant Donor Svcs of OK,OKOP,1999,7664,400,,75,256,5,,19,64,56,1121,23,,,75,256,75,0,256,75,0,100,0,100,0,75,0,100,0,757
 OKOP-OP1 LifeShare Transplant Donor Svcs of OK,LifeShare Transplant Donor Svcs of OK,OKOP,2000,7431,376,,67,230,5,,18,61,57,1052,22,,,67,230,67,0,230,67,0,100,0,100,0,67,0,100,0,758
 OKOP-OP1 LifeShare Transplant Donor Svcs of OK,LifeShare Transplant Donor Svcs of OK,OKOP,2001,7249,380,,74,276,5,,19,73,69,1059,26,,,74,276,74,0,276,74,0,100,0,100,0,74,0,100,0,759
 OKOP-OP1 LifeShare Transplant Donor Svcs of OK,LifeShare Transplant Donor Svcs of OK,OKOP,2002,7422,378,,61,232,5,,16,61,55,1060,22,,,61,232,61,0,232,61,0,100,0,100,0,61,0,100,0,760
 OKOP-OP1 LifeShare Transplant Donor Svcs of OK,LifeShare Transplant Donor Svcs of OK,OKOP,2003,7354,368,,91,303,5,,25,82,77,1028,29,,,91,303,91,0,303,91,0,100,0,100,0,91,0,100,0,761
 OKOP-OP1 LifeShare Transplant Donor Svcs of OK,LifeShare Transplant Donor Svcs of OK,OKOP,2004,6992,394,,92,322,6,,23,82,73,1096,29,,,92,322,92,3,319,91,1,99,1,99,1,91,1,99,1,762
 OKOP-OP1 LifeShare Transplant Donor Svcs of OK,LifeShare Transplant Donor Svcs of OK,OKOP,2005,7292,388,,87,279,5,,22,72,65,1078,26,,,87,279,87,0,279,87,0,100,0,100,0,87,0,100,0,763
 OKOP-OP1 LifeShare Transplant Donor Svcs of OK,LifeShare Transplant Donor Svcs of OK,OKOP,2006,7035,363,,67,227,5,,18,63,55,1004,23,,,67,227,67,5,222,64,3,96,4,98,2,64,3,96,4,764
 OKOP-OP1 LifeShare Transplant Donor Svcs of OK,LifeShare Transplant Donor Svcs of OK,OKOP,2007,7095,394,,109,332,6,,28,84,72,1083,31,,,109,332,109,2,330,108,1,99,1,99,1,108,1,99,1,765
 OKOP-OP1 LifeShare Transplant Donor Svcs of OK,LifeShare Transplant Donor Svcs of OK,OKOP,2008,7311,394,136,83,264,5,35,21,67,59,1091,24,,,83,264,83,7,257,80,3,96,4,97,3,80,3,96,4,766
 OKOP-OP1 LifeShare Transplant Donor Svcs of OK,LifeShare Transplant Donor Svcs of OK,OKOP,2009,7165,429,142,81,262,6,33,19,61,53,1180,22,,,81,262,81,6,256,78,3,96,4,98,2,78,3,96,4,767
 OKOP-OP1 LifeShare Transplant Donor Svcs of OK,LifeShare Transplant Donor Svcs of OK,OKOP,2010,7217,432,90,81,288,6,21,19,67,60,1190,24,,,81,288,81,15,273,75,6,93,7,95,5,75,6,93,7,768
 OKOP-OP1 LifeShare Transplant Donor Svcs of OK,LifeShare Transplant Donor Svcs of OK,OKOP,2011,7223,440,99,99,325,6,22,22,74,66,1209,27,74,79,99,325,99,28,297,88,11,89,11,91,9,88,11,89,11,769
 OKOP-OP1 LifeShare Transplant Donor Svcs of OK,LifeShare Transplant Donor Svcs of OK,OKOP,2012,6957,421,102,94,360,6,24,22,86,77,1157,31,74,78,94,360,94,25,335,84,10,89,11,93,7,84,10,89,11,770
 OKOP-OP1 LifeShare Transplant Donor Svcs of OK,LifeShare Transplant Donor Svcs of OK,OKOP,2013,7293,413,102,89,326,6,25,22,79,70,1145,28,67,72,89,326,89,40,286,71,18,80,20,88,12,71,18,80,20,771
 OKOP-OP1 LifeShare Transplant Donor Svcs of OK,LifeShare Transplant Donor Svcs of OK,OKOP,2014,7417,414,132,141,495,6,32,34,119,107,1140,43,81,85,141,495,141,52,443,118,23,84,16,89,11,118,23,84,16,772
 OKOP-OP1 LifeShare Transplant Donor Svcs of OK,LifeShare Transplant Donor Svcs of OK,OKOP,2015,7223,446,165,174,542,6,37,39,122,107,1224,44,75,81,174,542,174,92,450,132,42,76,24,83,17,132,42,76,24,773
 OKOP-OP1 LifeShare Transplant Donor Svcs of OK,LifeShare Transplant Donor Svcs of OK,OKOP,2016,7299,470,162,180,572,6,34,38,122,103,1290,44,67,77,180,572,180,145,427,116,64,64,36,75,25,116,64,64,36,774
 ORUO-IO1 Pacific NW Transplant Bank,Pacific NW Transplant Bank,ORUO,1999,4776,292,,85,323,6,,29,111,95,818,39,,,85,323,85,0,323,85,0,100,0,100,0,85,0,100,0,775
 ORUO-IO1 Pacific NW Transplant Bank,Pacific NW Transplant Bank,ORUO,2000,4773,297,,86,340,6,,29,114,97,835,41,,,86,340,86,0,340,86,0,100,0,100,0,86,0,100,0,776
 ORUO-IO1 Pacific NW Transplant Bank,Pacific NW Transplant Bank,ORUO,2001,4936,305,,89,338,6,,29,111,89,851,40,,,89,338,89,0,338,89,0,100,0,100,0,89,0,100,0,777
 ORUO-IO1 Pacific NW Transplant Bank,Pacific NW Transplant Bank,ORUO,2002,4893,298,,73,290,6,,24,97,86,831,35,,,73,290,73,2,288,72,1,99,1,99,1,72,1,99,1,778
 ORUO-IO1 Pacific NW Transplant Bank,Pacific NW Transplant Bank,ORUO,2003,4925,322,,88,327,7,,27,102,88,890,37,,,88,327,88,4,323,86,2,98,2,99,1,86,2,98,2,779
 ORUO-IO1 Pacific NW Transplant Bank,Pacific NW Transplant Bank,ORUO,2004,4548,304,,84,314,7,,28,103,92,839,37,,,84,314,84,0,314,84,0,100,0,100,0,84,0,100,0,780
 ORUO-IO1 Pacific NW Transplant Bank,Pacific NW Transplant Bank,ORUO,2005,4699,311,,87,322,7,,28,104,89,858,38,,,87,322,87,18,304,80,7,92,8,94,6,80,7,92,8,781
 ORUO-IO1 Pacific NW Transplant Bank,Pacific NW Transplant Bank,ORUO,2006,4749,319,,103,387,7,,32,121,109,879,44,,,103,387,103,30,357,94,9,91,9,92,8,94,9,91,9,782
 ORUO-IO1 Pacific NW Transplant Bank,Pacific NW Transplant Bank,ORUO,2007,4733,346,,87,348,7,,25,101,90,956,36,,,87,348,87,17,331,81,6,93,7,95,5,81,6,93,7,783
 ORUO-IO1 Pacific NW Transplant Bank,Pacific NW Transplant Bank,ORUO,2008,4763,302,85,69,260,6,28,23,86,77,837,31,,,69,260,69,25,235,60,9,87,13,90,10,60,9,87,13,784
 ORUO-IO1 Pacific NW Transplant Bank,Pacific NW Transplant Bank,ORUO,2009,4746,338,103,93,353,7,30,28,104,97,928,38,,,93,353,93,32,321,81,12,87,13,91,9,81,12,87,13,785
 ORUO-IO1 Pacific NW Transplant Bank,Pacific NW Transplant Bank,ORUO,2010,4623,333,89,79,287,7,27,24,86,77,922,31,,,79,287,79,27,260,70,9,89,11,91,9,70,9,89,11,786
 ORUO-IO1 Pacific NW Transplant Bank,Pacific NW Transplant Bank,ORUO,2011,4735,362,102,86,297,8,28,24,82,75,995,30,72,75,86,297,86,34,263,73,13,85,15,89,11,73,13,85,15,787
 ORUO-IO1 Pacific NW Transplant Bank,Pacific NW Transplant Bank,ORUO,2012,4754,364,95,75,271,8,26,21,74,68,999,27,73,74,75,271,75,12,259,70,5,93,7,96,4,70,5,93,7,788
 ORUO-IO1 Pacific NW Transplant Bank,Pacific NW Transplant Bank,ORUO,2013,4935,369,109,94,331,7,30,25,90,86,1022,32,70,74,94,331,94,41,290,76,18,81,19,88,12,76,18,81,19,789
 ORUO-IO1 Pacific NW Transplant Bank,Pacific NW Transplant Bank,ORUO,2014,5066,365,78,91,294,7,21,25,81,74,1006,29,77,83,91,294,91,76,218,61,30,67,33,74,26,61,30,67,33,790
 ORUO-IO1 Pacific NW Transplant Bank,Pacific NW Transplant Bank,ORUO,2015,5289,404,109,120,385,8,27,30,95,81,1118,34,76,82,120,385,120,90,295,84,36,70,30,77,23,84,36,70,30,791
 ORUO-IO1 Pacific NW Transplant Bank,Pacific NW Transplant Bank,ORUO,2016,5468,370,111,121,419,7,30,33,113,106,1023,41,84,87,121,419,121,69,350,93,28,77,23,84,16,93,28,77,23,792
 PADV-OP1 Gift of Life Donor Program,Gift of Life Donor Program,PADV,1999,19589,894,,329,1182,5,,37,132,113,2525,47,,,329,1182,329,61,1121,305,24,93,7,95,5,305,24,93,7,793
 PADV-OP1 Gift of Life Donor Program,Gift of Life Donor Program,PADV,2000,19466,919,,298,1036,5,,32,113,92,2579,40,,,298,1036,298,58,978,275,23,92,8,94,6,275,23,92,8,794
 PADV-OP1 Gift of Life Donor Program,Gift of Life Donor Program,PADV,2001,18966,888,,314,1143,5,,35,129,110,2499,46,,,314,1143,314,88,1055,282,32,90,10,92,8,282,32,90,10,795
 PADV-OP1 Gift of Life Donor Program,Gift of Life Donor Program,PADV,2002,18699,896,,354,1267,5,,40,141,125,2506,51,,,354,1267,354,93,1174,318,36,90,10,93,7,318,36,90,10,796
 PADV-OP1 Gift of Life Donor Program,Gift of Life Donor Program,PADV,2003,18535,853,,344,1169,5,,40,137,123,2395,49,,,344,1169,344,118,1051,293,51,85,15,90,10,293,51,85,15,797
 PADV-OP1 Gift of Life Donor Program,Gift of Life Donor Program,PADV,2004,18053,876,,387,1320,5,,44,151,130,2440,54,,,387,1320,387,112,1208,340,47,88,12,92,8,340,47,88,12,798
 PADV-OP1 Gift of Life Donor Program,Gift of Life Donor Program,PADV,2005,18200,891,,382,1315,5,,43,148,130,2474,53,,,382,1315,382,139,1176,326,56,85,15,89,11,326,56,85,15,799
 PADV-OP1 Gift of Life Donor Program,Gift of Life Donor Program,PADV,2006,17800,879,,401,1325,5,,46,151,129,2441,54,,,401,1325,401,164,1161,335,66,84,16,88,12,335,66,84,16,800
 PADV-OP1 Gift of Life Donor Program,Gift of Life Donor Program,PADV,2007,17203,884,,389,1313,5,,44,148,120,2444,54,,,389,1313,389,112,1201,343,46,88,12,91,9,343,46,88,12,801
 PADV-OP1 Gift of Life Donor Program,Gift of Life Donor Program,PADV,2008,16606,923,442,428,1442,6,48,46,156,125,2540,57,,,428,1442,428,166,1276,358,70,84,16,88,12,358,70,84,16,802
 PADV-OP1 Gift of Life Donor Program,Gift of Life Donor Program,PADV,2009,15573,884,446,439,1424,6,50,50,161,126,2434,59,,,439,1424,439,153,1271,374,65,85,15,89,11,374,65,85,15,803
 PADV-OP1 Gift of Life Donor Program,Gift of Life Donor Program,PADV,2010,15090,894,375,392,1382,6,42,44,155,125,2471,56,,,392,1382,392,192,1190,307,85,78,22,86,14,307,85,78,22,804
 PADV-OP1 Gift of Life Donor Program,Gift of Life Donor Program,PADV,2011,15153,938,416,441,1531,6,44,47,163,126,2582,59,78,83,441,1531,441,196,1335,357,84,81,19,87,13,357,84,81,19,805
 PADV-OP1 Gift of Life Donor Program,Gift of Life Donor Program,PADV,2012,14993,897,414,417,1470,6,46,46,164,118,2486,59,72,78,417,1470,417,160,1310,352,65,84,16,89,11,352,65,84,16,806
 PADV-OP1 Gift of Life Donor Program,Gift of Life Donor Program,PADV,2013,14935,859,466,447,1618,6,54,52,188,143,2375,68,73,78,447,1618,447,153,1465,386,61,86,14,91,9,386,61,86,14,807
 PADV-OP1 Gift of Life Donor Program,Gift of Life Donor Program,PADV,2014,15181,932,464,447,1521,6,50,48,163,122,2578,59,76,80,447,1521,447,163,1358,381,66,85,15,89,11,381,66,85,15,808
 PADV-OP1 Gift of Life Donor Program,Gift of Life Donor Program,PADV,2015,15907,934,465,483,1684,6,50,52,180,138,2589,65,76,81,483,1684,483,204,1480,400,83,83,17,88,12,400,83,83,17,809
 PADV-OP1 Gift of Life Donor Program,Gift of Life Donor Program,PADV,2016,15868,948,529,540,1853,6,56,57,195,149,2621,71,75,80,540,1853,540,239,1614,443,97,82,18,87,13,443,97,82,18,810
 PATF-OP1 Center for Organ Recovery and Educ.,Center for Organ Recovery and Educ.,PATF,1999,4889,246,,178,688,5,,72,280,233,692,99,,,178,688,178,10,678,174,4,98,2,99,1,174,4,98,2,811
 PATF-OP1 Center for Organ Recovery and Educ.,Center for Organ Recovery and Educ.,PATF,2000,4860,278,,153,559,6,,55,201,167,778,72,,,153,559,153,23,536,144,9,94,6,96,4,144,9,94,6,812
 PATF-OP1 Center for Organ Recovery and Educ.,Center for Organ Recovery and Educ.,PATF,2001,4856,273,,156,599,6,,57,219,182,765,78,,,156,599,156,38,561,142,14,91,9,94,6,142,14,91,9,813
 PATF-OP1 Center for Organ Recovery and Educ.,Center for Organ Recovery and Educ.,PATF,2002,4920,273,,155,541,6,,57,198,164,761,71,,,155,541,155,32,509,142,13,92,8,94,6,142,13,92,8,814
 PATF-OP1 Center for Organ Recovery and Educ.,Center for Organ Recovery and Educ.,PATF,2003,4960,263,,167,612,5,,63,232,188,735,83,,,167,612,167,33,579,154,13,92,8,95,5,154,13,92,8,815
 PATF-OP1 Center for Organ Recovery and Educ.,Center for Organ Recovery and Educ.,PATF,2004,5129,299,,151,529,6,,51,177,133,825,64,,,151,529,151,43,486,135,16,89,11,92,8,135,16,89,11,816
 PATF-OP1 Center for Organ Recovery and Educ.,Center for Organ Recovery and Educ.,PATF,2005,4982,307,,156,574,6,,51,187,129,846,68,,,156,574,156,62,512,133,23,85,15,89,11,133,23,85,15,817
 PATF-OP1 Center for Organ Recovery and Educ.,Center for Organ Recovery and Educ.,PATF,2006,4777,303,,186,669,6,,61,221,167,831,81,,,186,669,186,66,603,162,24,87,13,90,10,162,24,87,13,818
 PATF-OP1 Center for Organ Recovery and Educ.,Center for Organ Recovery and Educ.,PATF,2007,4587,283,,205,688,6,,72,243,164,779,88,,,205,688,205,115,573,164,41,80,20,83,17,164,41,80,20,819
 PATF-OP1 Center for Organ Recovery and Educ.,Center for Organ Recovery and Educ.,PATF,2008,4554,274,152,214,664,6,55,78,242,172,753,88,,,214,664,214,113,551,169,45,79,21,83,17,169,45,79,21,820
 PATF-OP1 Center for Organ Recovery and Educ.,Center for Organ Recovery and Educ.,PATF,2009,4479,291,147,218,719,6,51,75,247,178,799,90,,,218,719,218,114,605,176,42,81,19,84,16,176,42,81,19,821
 PATF-OP1 Center for Organ Recovery and Educ.,Center for Organ Recovery and Educ.,PATF,2010,4602,307,178,213,752,7,58,69,245,167,847,89,,,213,752,213,99,653,180,33,85,15,87,13,180,33,85,15,822
 PATF-OP1 Center for Organ Recovery and Educ.,Center for Organ Recovery and Educ.,PATF,2011,4598,313,157,211,694,7,50,68,222,159,861,81,81,88,211,694,211,66,628,185,26,88,12,90,10,185,26,88,12,823
 PATF-OP1 Center for Organ Recovery and Educ.,Center for Organ Recovery and Educ.,PATF,2012,4634,308,128,194,632,7,42,63,205,166,845,75,84,90,194,632,194,73,559,166,28,86,14,88,12,166,28,86,14,824
 PATF-OP1 Center for Organ Recovery and Educ.,Center for Organ Recovery and Educ.,PATF,2013,4749,286,151,205,682,6,53,72,238,192,794,86,80,87,205,682,205,77,605,175,30,85,15,89,11,175,30,85,15,825
 PATF-OP1 Center for Organ Recovery and Educ.,Center for Organ Recovery and Educ.,PATF,2014,4927,312,168,200,641,6,54,64,206,172,857,75,83,87,200,641,200,66,575,172,28,86,14,90,10,172,28,86,14,826
 PATF-OP1 Center for Organ Recovery and Educ.,Center for Organ Recovery and Educ.,PATF,2015,5135,329,175,207,709,6,53,63,216,182,907,78,85,88,207,709,207,95,614,171,36,83,17,87,13,171,36,83,17,827
 PATF-OP1 Center for Organ Recovery and Educ.,Center for Organ Recovery and Educ.,PATF,2016,5261,360,203,237,785,7,56,66,218,184,988,79,85,89,237,785,237,111,674,195,42,82,18,86,14,195,42,82,18,828
" SCOP-OP1 LifePoint, Inc.","LifePoint, Inc.",SCOP,1999,8874,511,,85,330,6,,17,65,59,1428,23,,,85,330,85,0,330,85,0,100,0,100,0,85,0,100,0,829
" SCOP-OP1 LifePoint, Inc.","LifePoint, Inc.",SCOP,2000,8742,517,,114,414,6,,22,80,70,1447,29,,,114,414,114,0,414,114,0,100,0,100,0,114,0,100,0,830
" SCOP-OP1 LifePoint, Inc.","LifePoint, Inc.",SCOP,2001,8486,492,,120,450,6,,24,91,79,1369,33,,,120,450,120,0,450,120,0,100,0,100,0,120,0,100,0,831
" SCOP-OP1 LifePoint, Inc.","LifePoint, Inc.",SCOP,2002,8598,514,,106,400,6,,21,78,65,1434,28,,,106,400,106,0,400,106,0,100,0,100,0,106,0,100,0,832
" SCOP-OP1 LifePoint, Inc.","LifePoint, Inc.",SCOP,2003,8669,468,,90,337,5,,19,72,60,1297,26,,,90,337,90,0,337,90,0,100,0,100,0,90,0,100,0,833
" SCOP-OP1 LifePoint, Inc.","LifePoint, Inc.",SCOP,2004,8263,500,,126,487,6,,25,97,77,1388,35,,,126,487,126,0,487,126,0,100,0,100,0,126,0,100,0,834
" SCOP-OP1 LifePoint, Inc.","LifePoint, Inc.",SCOP,2005,8297,466,,140,548,6,,30,118,92,1295,42,,,140,548,140,0,548,140,0,100,0,100,0,140,0,100,0,835
" SCOP-OP1 LifePoint, Inc.","LifePoint, Inc.",SCOP,2006,8282,508,,193,689,6,,38,136,107,1397,49,,,193,689,193,9,680,190,3,98,2,99,1,190,3,98,2,836
" SCOP-OP1 LifePoint, Inc.","LifePoint, Inc.",SCOP,2007,8152,563,,193,688,7,,34,122,95,1550,44,,,193,688,193,3,685,192,1,99,1,100,0,192,1,99,1,837
" SCOP-OP1 LifePoint, Inc.","LifePoint, Inc.",SCOP,2008,7659,491,207,158,575,6,42,32,117,98,1355,42,,,158,575,158,6,569,156,2,99,1,99,1,156,2,99,1,838
" SCOP-OP1 LifePoint, Inc.","LifePoint, Inc.",SCOP,2009,7621,511,175,133,489,7,34,26,96,77,1407,35,,,133,489,133,0,489,133,0,100,0,100,0,133,0,100,0,839
" SCOP-OP1 LifePoint, Inc.","LifePoint, Inc.",SCOP,2010,7815,531,166,118,476,7,31,22,90,76,1459,33,,,118,476,118,0,476,118,0,100,0,100,0,118,0,100,0,840
" SCOP-OP1 LifePoint, Inc.","LifePoint, Inc.",SCOP,2011,7426,489,163,126,528,7,33,26,108,96,1346,39,77,77,126,528,126,3,525,125,1,99,1,99,1,125,1,99,1,841
" SCOP-OP1 LifePoint, Inc.","LifePoint, Inc.",SCOP,2012,7420,506,145,103,385,7,29,20,76,66,1384,28,71,71,103,385,103,0,385,103,0,100,0,100,0,103,0,100,0,842
" SCOP-OP1 LifePoint, Inc.","LifePoint, Inc.",SCOP,2013,7779,568,141,104,426,7,25,18,75,64,1561,27,72,73,104,426,104,3,423,103,1,99,1,99,1,103,1,99,1,843
" SCOP-OP1 LifePoint, Inc.","LifePoint, Inc.",SCOP,2014,7798,523,155,111,452,7,30,21,86,75,1438,31,70,70,111,452,111,4,448,109,2,98,2,99,1,109,2,98,2,844
" SCOP-OP1 LifePoint, Inc.","LifePoint, Inc.",SCOP,2015,8142,573,163,123,484,7,28,21,85,73,1570,31,75,75,123,484,123,2,482,122,1,99,1,100,0,122,1,99,1,845
" SCOP-OP1 LifePoint, Inc.","LifePoint, Inc.",SCOP,2016,8455,601,169,127,532,7,28,21,89,76,1650,32,71,72,127,532,127,17,515,120,7,94,6,97,3,120,7,94,6,846
 TNDS-OP1 Tennessee Donor Svcs,Tennessee Donor Svcs,TNDS,1999,12722,670,,105,421,5,,16,63,57,1882,22,,,105,421,105,2,419,104,1,99,1,100,0,104,1,99,1,847
 TNDS-OP1 Tennessee Donor Svcs,Tennessee Donor Svcs,TNDS,2000,12703,709,,109,433,6,,15,61,56,1994,22,,,109,433,109,0,433,109,0,100,0,100,0,109,0,100,0,848
 TNDS-OP1 Tennessee Donor Svcs,Tennessee Donor Svcs,TNDS,2001,12392,707,,123,432,6,,17,61,53,1978,22,,,123,432,123,0,432,123,0,100,0,100,0,123,0,100,0,849
 TNDS-OP1 Tennessee Donor Svcs,Tennessee Donor Svcs,TNDS,2002,12523,673,,147,551,5,,22,82,73,1873,29,,,147,551,147,0,551,147,0,100,0,100,0,147,0,100,0,850
 TNDS-OP1 Tennessee Donor Svcs,Tennessee Donor Svcs,TNDS,2003,12414,671,,145,503,5,,22,75,67,1864,27,,,145,503,145,0,503,145,0,100,0,100,0,145,0,100,0,851
 TNDS-OP1 Tennessee Donor Svcs,Tennessee Donor Svcs,TNDS,2004,11878,712,,158,597,6,,22,84,75,1967,30,,,158,597,158,0,597,158,0,100,0,100,0,158,0,100,0,852
 TNDS-OP1 Tennessee Donor Svcs,Tennessee Donor Svcs,TNDS,2005,11764,715,,168,632,6,,23,88,79,1973,32,,,168,632,168,0,632,168,0,100,0,100,0,168,0,100,0,853
 TNDS-OP1 Tennessee Donor Svcs,Tennessee Donor Svcs,TNDS,2006,12089,753,,202,770,6,,27,102,89,2076,37,,,202,770,202,13,757,197,5,98,2,98,2,197,5,98,2,854
 TNDS-OP1 Tennessee Donor Svcs,Tennessee Donor Svcs,TNDS,2007,11680,696,,196,716,6,,28,103,88,1919,37,,,196,716,196,19,697,189,7,96,4,97,3,189,7,96,4,855
 TNDS-OP1 Tennessee Donor Svcs,Tennessee Donor Svcs,TNDS,2008,11691,702,260,188,717,6,37,27,102,85,1935,37,,,188,717,188,37,680,174,14,93,7,95,5,174,14,93,7,856
 TNDS-OP1 Tennessee Donor Svcs,Tennessee Donor Svcs,TNDS,2009,11707,735,324,240,857,6,44,33,117,95,2029,42,,,240,857,240,45,812,222,18,93,8,95,5,222,18,93,8,857
 TNDS-OP1 Tennessee Donor Svcs,Tennessee Donor Svcs,TNDS,2010,11539,730,244,198,706,6,33,27,97,82,2016,35,,,198,706,198,43,663,179,19,90,10,94,6,179,19,90,10,858
 TNDS-OP1 Tennessee Donor Svcs,Tennessee Donor Svcs,TNDS,2011,11604,741,275,220,834,6,37,30,113,94,2043,41,70,73,220,834,220,52,782,198,22,90,10,94,6,198,22,90,10,859
 TNDS-OP1 Tennessee Donor Svcs,Tennessee Donor Svcs,TNDS,2012,11754,727,259,241,840,6,36,33,116,94,2008,42,75,79,241,840,241,77,763,211,30,88,12,91,9,211,30,88,12,860
 TNDS-OP1 Tennessee Donor Svcs,Tennessee Donor Svcs,TNDS,2013,11940,707,226,241,932,6,32,34,132,112,1967,47,85,87,241,932,241,50,882,223,18,93,7,95,5,223,18,93,7,861
 TNDS-OP1 Tennessee Donor Svcs,Tennessee Donor Svcs,TNDS,2014,12427,772,234,257,914,6,30,33,118,100,2143,43,77,83,257,914,257,77,837,228,29,89,11,92,8,228,29,89,11,862
 TNDS-OP1 Tennessee Donor Svcs,Tennessee Donor Svcs,TNDS,2015,12355,738,244,249,949,6,33,34,129,110,2049,46,70,78,249,949,249,50,899,229,20,92,8,95,5,229,20,92,8,863
 TNDS-OP1 Tennessee Donor Svcs,Tennessee Donor Svcs,TNDS,2016,12592,809,297,294,1067,6,37,36,132,111,2236,48,76,81,294,1067,294,49,1018,273,21,93,7,95,5,273,21,93,7,864
 TNMS-OP1 Mid-South Transplant Foundation,Mid-South Transplant Foundation,TNMS,1999,4794,267,,41,137,6,,15,51,43,750,18,,,41,137,41,0,137,41,0,100,0,100,0,41,0,100,0,865
 TNMS-OP1 Mid-South Transplant Foundation,Mid-South Transplant Foundation,TNMS,2000,4795,242,,31,106,5,,13,44,39,680,16,,,31,106,31,0,106,31,0,100,0,100,0,31,0,100,0,866
 TNMS-OP1 Mid-South Transplant Foundation,Mid-South Transplant Foundation,TNMS,2001,4587,231,,37,125,5,,16,54,48,647,19,,,37,125,37,0,125,37,0,100,0,100,0,37,0,100,0,867
 TNMS-OP1 Mid-South Transplant Foundation,Mid-South Transplant Foundation,TNMS,2002,4721,237,,41,152,5,,17,64,53,664,23,,,41,152,41,0,152,41,0,100,0,100,0,41,0,100,0,868
 TNMS-OP1 Mid-South Transplant Foundation,Mid-South Transplant Foundation,TNMS,2003,4545,241,,33,110,5,,14,46,41,675,16,,,33,110,33,0,110,33,0,100,0,100,0,33,0,100,0,869
 TNMS-OP1 Mid-South Transplant Foundation,Mid-South Transplant Foundation,TNMS,2004,4340,228,,31,126,5,,14,55,47,630,20,,,31,126,31,0,126,31,0,100,0,100,0,31,0,100,0,870
 TNMS-OP1 Mid-South Transplant Foundation,Mid-South Transplant Foundation,TNMS,2005,4580,268,,43,148,6,,16,55,49,740,20,,,43,148,43,0,148,43,0,100,0,100,0,43,0,100,0,871
 TNMS-OP1 Mid-South Transplant Foundation,Mid-South Transplant Foundation,TNMS,2006,4361,258,,59,196,6,,23,76,67,713,27,,,59,196,59,6,190,57,2,97,3,97,3,57,2,97,3,872
 TNMS-OP1 Mid-South Transplant Foundation,Mid-South Transplant Foundation,TNMS,2007,4456,273,,51,164,6,,19,60,52,750,22,,,51,164,51,25,139,41,10,80,20,85,15,41,10,80,20,873
 TNMS-OP1 Mid-South Transplant Foundation,Mid-South Transplant Foundation,TNMS,2008,4409,278,82,59,188,6,29,21,68,54,763,25,,,59,188,59,15,173,53,6,90,10,92,8,53,6,90,10,874
 TNMS-OP1 Mid-South Transplant Foundation,Mid-South Transplant Foundation,TNMS,2009,4330,275,82,77,258,6,30,28,94,79,755,34,,,77,258,77,16,242,70,7,91,9,94,6,70,7,91,9,875
 TNMS-OP1 Mid-South Transplant Foundation,Mid-South Transplant Foundation,TNMS,2010,4292,267,84,71,260,6,31,27,97,84,736,35,,,71,260,71,10,250,67,4,94,6,96,4,67,4,94,6,876
 TNMS-OP1 Mid-South Transplant Foundation,Mid-South Transplant Foundation,TNMS,2011,4197,268,70,61,231,6,26,23,86,74,737,31,81,82,61,231,61,6,225,58,3,95,5,97,3,58,3,95,5,877
 TNMS-OP1 Mid-South Transplant Foundation,Mid-South Transplant Foundation,TNMS,2012,4238,259,71,60,248,6,27,23,96,84,716,35,80,81,60,248,60,6,242,58,2,97,3,98,2,58,2,97,3,878
 TNMS-OP1 Mid-South Transplant Foundation,Mid-South Transplant Foundation,TNMS,2013,4380,250,81,71,265,6,32,28,106,94,690,38,79,81,71,265,71,18,247,64,7,90,10,93,7,64,7,90,10,879
 TNMS-OP1 Mid-South Transplant Foundation,Mid-South Transplant Foundation,TNMS,2014,4265,258,69,64,220,6,27,25,85,69,709,31,81,83,64,220,64,14,206,58,6,91,9,94,6,58,6,91,9,880
 TNMS-OP1 Mid-South Transplant Foundation,Mid-South Transplant Foundation,TNMS,2015,4324,234,66,52,190,5,28,22,81,77,643,30,77,78,52,190,52,3,187,51,1,98,2,98,2,51,1,98,2,881
 TNMS-OP1 Mid-South Transplant Foundation,Mid-South Transplant Foundation,TNMS,2016,4322,255,71,52,208,6,28,20,81,74,699,30,65,68,52,208,52,17,191,46,6,88,12,92,8,46,6,88,12,882
 TXGC-OP1 LifeGift Organ Donation Ctr,LifeGift Organ Donation Ctr,TXGC,1999,13703,701,,194,649,5,,28,93,84,1957,33,,,194,649,194,0,646,193,0,99,0,100,0,193,0,99,0,883
 TXGC-OP1 LifeGift Organ Donation Ctr,LifeGift Organ Donation Ctr,TXGC,2000,13475,738,,188,642,5,,25,87,83,2059,31,,,188,642,188,0,642,188,0,100,0,100,0,188,0,100,0,884
 TXGC-OP1 LifeGift Organ Donation Ctr,LifeGift Organ Donation Ctr,TXGC,2001,13895,778,,198,668,6,,25,86,78,2162,31,,,198,668,198,0,668,198,0,100,0,100,0,198,0,100,0,885
 TXGC-OP1 LifeGift Organ Donation Ctr,LifeGift Organ Donation Ctr,TXGC,2002,14176,813,,206,756,6,,25,93,88,2241,34,,,206,756,206,0,756,206,0,100,0,100,0,206,0,100,0,886
 TXGC-OP1 LifeGift Organ Donation Ctr,LifeGift Organ Donation Ctr,TXGC,2003,13833,763,,202,693,6,,26,91,86,2098,33,,,202,693,202,2,691,201,1,100,0,100,0,201,1,100,0,887
 TXGC-OP1 LifeGift Organ Donation Ctr,LifeGift Organ Donation Ctr,TXGC,2004,13170,758,,257,881,6,,34,116,105,2084,42,,,257,881,257,4,877,255,2,99,1,100,0,255,2,99,1,888
 TXGC-OP1 LifeGift Organ Donation Ctr,LifeGift Organ Donation Ctr,TXGC,2005,12994,747,,257,873,6,,34,117,106,2050,43,,,257,873,257,2,871,256,1,100,0,100,0,256,1,100,0,889
 TXGC-OP1 LifeGift Organ Donation Ctr,LifeGift Organ Donation Ctr,TXGC,2006,12540,788,,289,979,6,,37,124,112,2148,46,,,289,979,289,6,973,286,3,99,1,99,1,286,3,99,1,890
 TXGC-OP1 LifeGift Organ Donation Ctr,LifeGift Organ Donation Ctr,TXGC,2007,14160,947,,297,982,7,,31,104,89,2573,38,,,297,982,297,24,958,286,11,96,4,98,2,286,11,96,4,891
 TXGC-OP1 LifeGift Organ Donation Ctr,LifeGift Organ Donation Ctr,TXGC,2008,15134,967,376,298,973,6,39,31,101,87,2625,37,,,298,973,298,30,943,284,14,95,5,97,3,284,14,95,5,892
 TXGC-OP1 LifeGift Organ Donation Ctr,LifeGift Organ Donation Ctr,TXGC,2009,13104,812,351,286,990,6,43,35,122,108,2219,45,,,286,990,286,56,934,262,24,92,8,94,6,262,24,92,8,893
 TXGC-OP1 LifeGift Organ Donation Ctr,LifeGift Organ Donation Ctr,TXGC,2010,13057,811,324,278,988,6,40,34,122,106,2220,45,,,278,988,278,51,937,254,24,91,9,95,5,254,24,91,9,894
 TXGC-OP1 LifeGift Organ Donation Ctr,LifeGift Organ Donation Ctr,TXGC,2011,12858,807,345,300,1060,6,43,37,131,117,2210,48,71,75,300,1060,300,113,947,248,52,83,17,89,11,248,52,83,17,895
 TXGC-OP1 LifeGift Organ Donation Ctr,LifeGift Organ Donation Ctr,TXGC,2012,13113,831,361,312,1142,6,43,38,137,119,2265,50,73,76,312,1142,312,78,1064,274,38,88,12,93,7,274,38,88,12,896
 TXGC-OP1 LifeGift Organ Donation Ctr,LifeGift Organ Donation Ctr,TXGC,2013,13394,802,330,282,1000,6,41,35,125,111,2194,46,72,75,282,1000,282,72,928,248,34,88,12,93,7,248,34,88,12,897
 TXGC-OP1 LifeGift Organ Donation Ctr,LifeGift Organ Donation Ctr,TXGC,2014,13860,798,339,287,1022,6,42,36,128,112,2183,47,69,73,287,1022,287,102,920,242,45,84,16,90,10,242,45,84,16,898
 TXGC-OP1 LifeGift Organ Donation Ctr,LifeGift Organ Donation Ctr,TXGC,2015,13927,816,337,283,966,6,41,35,118,105,2234,43,66,71,283,966,283,105,861,237,46,84,16,89,11,237,46,84,16,899
 TXGC-OP1 LifeGift Organ Donation Ctr,LifeGift Organ Donation Ctr,TXGC,2016,14464,926,474,414,1423,6,51,45,154,131,2529,56,68,73,414,1423,414,154,1269,342,72,83,17,89,11,342,72,83,17,900
 TXSA-OP1 Texas Organ Sharing Alliance,Texas Organ Sharing Alliance,TXSA,1999,7440,386,,94,344,5,,24,89,81,1082,32,,,94,344,94,0,344,94,0,100,0,100,0,94,0,100,0,901
 TXSA-OP1 Texas Organ Sharing Alliance,Texas Organ Sharing Alliance,TXSA,2000,7302,404,,114,389,6,,28,96,87,1123,35,,,114,389,114,2,387,113,1,99,1,99,1,113,1,99,1,902
 TXSA-OP1 Texas Organ Sharing Alliance,Texas Organ Sharing Alliance,TXSA,2001,7462,441,,104,385,6,,24,87,81,1230,31,,,104,385,104,6,379,102,2,98,2,98,2,102,2,98,2,903
 TXSA-OP1 Texas Organ Sharing Alliance,Texas Organ Sharing Alliance,TXSA,2002,7433,453,,130,442,6,,29,98,90,1256,35,,,130,442,130,6,436,127,3,98,2,99,1,127,3,98,2,904
 TXSA-OP1 Texas Organ Sharing Alliance,Texas Organ Sharing Alliance,TXSA,2003,7485,430,,109,396,6,,25,92,84,1188,33,,,109,396,109,9,387,106,3,97,3,98,2,106,3,97,3,905
 TXSA-OP1 Texas Organ Sharing Alliance,Texas Organ Sharing Alliance,TXSA,2004,7044,405,,110,388,6,,27,96,80,1111,35,,,110,388,110,4,384,108,2,98,2,99,1,108,2,98,2,906
 TXSA-OP1 Texas Organ Sharing Alliance,Texas Organ Sharing Alliance,TXSA,2005,7082,438,,119,383,6,,27,87,79,1205,32,,,119,383,119,9,374,116,3,97,3,98,2,116,3,97,3,907
 TXSA-OP1 Texas Organ Sharing Alliance,Texas Organ Sharing Alliance,TXSA,2006,7135,445,,109,352,6,,24,79,70,1220,29,,,109,352,109,9,343,106,3,97,3,97,3,106,3,97,3,908
 TXSA-OP1 Texas Organ Sharing Alliance,Texas Organ Sharing Alliance,TXSA,2007,8069,531,,119,430,7,,22,81,72,1446,30,,,119,430,119,7,423,116,3,97,3,98,2,116,3,97,3,909
 TXSA-OP1 Texas Organ Sharing Alliance,Texas Organ Sharing Alliance,TXSA,2008,8304,511,158,115,423,6,31,22,83,76,1393,30,,,115,423,115,11,412,111,4,97,3,97,3,111,4,97,3,910
 TXSA-OP1 Texas Organ Sharing Alliance,Texas Organ Sharing Alliance,TXSA,2009,7521,489,135,88,342,6,28,18,70,63,1336,26,,,88,342,88,11,331,84,4,95,5,97,3,84,4,95,5,911
 TXSA-OP1 Texas Organ Sharing Alliance,Texas Organ Sharing Alliance,TXSA,2010,7422,482,155,116,453,6,32,24,94,86,1314,34,,,116,453,116,3,450,115,1,99,1,99,1,115,1,99,1,912
 TXSA-OP1 Texas Organ Sharing Alliance,Texas Organ Sharing Alliance,TXSA,2011,7548,507,137,105,410,7,27,21,81,73,1382,30,73,74,105,410,105,4,406,103,2,98,2,99,1,103,2,98,2,913
 TXSA-OP1 Texas Organ Sharing Alliance,Texas Organ Sharing Alliance,TXSA,2012,7724,491,143,94,383,6,29,19,78,72,1337,29,64,64,94,383,94,3,380,93,1,99,1,99,1,93,1,99,1,914
 TXSA-OP1 Texas Organ Sharing Alliance,Texas Organ Sharing Alliance,TXSA,2013,7813,518,163,119,476,7,31,23,92,84,1419,34,67,69,119,476,119,8,468,115,4,97,3,98,2,115,4,97,3,915
 TXSA-OP1 Texas Organ Sharing Alliance,Texas Organ Sharing Alliance,TXSA,2014,8177,495,153,134,536,6,31,27,108,101,1360,39,76,79,134,536,134,27,509,123,11,92,8,95,5,123,11,92,8,916
 TXSA-OP1 Texas Organ Sharing Alliance,Texas Organ Sharing Alliance,TXSA,2015,8212,539,157,133,503,7,29,25,93,84,1480,34,73,76,133,503,133,35,468,120,13,90,10,93,7,120,13,90,10,917
 TXSA-OP1 Texas Organ Sharing Alliance,Texas Organ Sharing Alliance,TXSA,2016,8210,539,161,139,547,7,30,26,102,93,1479,37,76,78,139,547,139,32,515,126,13,91,9,94,6,126,13,91,9,918
 TXSB-OP1 Southwest Transplant Alliance,Southwest Transplant Alliance,TXSB,1999,13083,785,,185,681,6,,24,87,82,2202,31,,,185,681,185,0,675,184,0,99,0,99,0,184,0,99,0,919
 TXSB-OP1 Southwest Transplant Alliance,Southwest Transplant Alliance,TXSB,2000,12915,717,,158,552,6,,22,77,73,2003,28,,,158,552,158,3,549,157,1,99,1,99,1,157,1,99,1,920
 TXSB-OP1 Southwest Transplant Alliance,Southwest Transplant Alliance,TXSB,2001,12667,716,,180,618,6,,25,86,80,1994,31,,,180,618,180,1,617,179,1,99,1,100,0,179,1,99,1,921
 TXSB-OP1 Southwest Transplant Alliance,Southwest Transplant Alliance,TXSB,2002,12784,768,,168,573,6,,22,75,71,2122,27,,,168,573,168,0,573,168,0,100,0,100,0,168,0,100,0,922
 TXSB-OP1 Southwest Transplant Alliance,Southwest Transplant Alliance,TXSB,2003,12583,736,,217,728,6,,29,99,90,2027,36,,,217,728,217,0,728,217,0,100,0,100,0,217,0,100,0,923
 TXSB-OP1 Southwest Transplant Alliance,Southwest Transplant Alliance,TXSB,2004,12408,772,,241,763,6,,31,99,90,2127,36,,,241,763,241,0,763,241,0,100,0,100,0,241,0,100,0,924
 TXSB-OP1 Southwest Transplant Alliance,Southwest Transplant Alliance,TXSB,2005,12114,745,,223,778,6,,30,104,94,2039,38,,,223,778,223,2,776,222,1,100,0,100,0,222,1,100,0,925
 TXSB-OP1 Southwest Transplant Alliance,Southwest Transplant Alliance,TXSB,2006,12164,758,,233,764,6,,31,101,92,2078,37,,,233,764,233,2,762,232,1,100,0,100,0,232,1,100,0,926
 TXSB-OP1 Southwest Transplant Alliance,Southwest Transplant Alliance,TXSB,2007,13132,884,,254,840,7,,29,95,85,2404,35,,,254,840,254,0,840,254,0,100,0,100,0,254,0,100,0,927
 TXSB-OP1 Southwest Transplant Alliance,Southwest Transplant Alliance,TXSB,2008,14439,905,340,226,786,6,38,25,87,81,2475,32,,,226,786,226,8,778,222,4,98,2,99,1,222,4,98,2,928
 TXSB-OP1 Southwest Transplant Alliance,Southwest Transplant Alliance,TXSB,2009,12075,796,319,239,828,7,40,30,104,91,2177,38,,,239,828,239,28,800,229,10,96,4,97,3,229,10,96,4,929
 TXSB-OP1 Southwest Transplant Alliance,Southwest Transplant Alliance,TXSB,2010,12086,764,326,252,859,6,43,33,112,100,2088,41,,,252,859,252,29,830,241,11,96,4,97,3,241,11,96,4,930
 TXSB-OP1 Southwest Transplant Alliance,Southwest Transplant Alliance,TXSB,2011,12097,793,250,232,803,7,32,29,101,91,2175,37,70,75,232,803,232,35,768,216,16,93,7,96,4,216,16,93,7,931
 TXSB-OP1 Southwest Transplant Alliance,Southwest Transplant Alliance,TXSB,2012,12152,808,248,250,832,7,31,31,103,89,2215,38,71,78,250,832,250,31,801,236,14,94,6,96,4,236,14,94,6,932
 TXSB-OP1 Southwest Transplant Alliance,Southwest Transplant Alliance,TXSB,2013,12372,806,339,247,924,7,42,31,115,102,2213,42,58,64,247,924,247,28,896,235,12,95,5,97,3,235,12,95,5,933
 TXSB-OP1 Southwest Transplant Alliance,Southwest Transplant Alliance,TXSB,2014,13025,832,380,314,1134,6,46,38,136,120,2283,50,65,70,314,1134,314,62,1072,289,25,92,8,95,5,289,25,92,8,934
 TXSB-OP1 Southwest Transplant Alliance,Southwest Transplant Alliance,TXSB,2015,13342,870,415,354,1284,7,48,41,148,129,2380,54,68,73,354,1284,354,81,1203,319,35,90,10,94,6,319,35,90,10,935
 TXSB-OP1 Southwest Transplant Alliance,Southwest Transplant Alliance,TXSB,2016,13395,872,395,380,1383,7,45,44,159,139,2391,58,66,74,380,1383,380,138,1245,333,47,88,12,90,10,333,47,88,12,936
 UTOP-OP1 Intermountain Donor Services,Intermountain Donor Services,UTOP,1999,2584,187,,61,227,7,,33,121,115,514,44,,,61,227,61,0,222,60,0,98,0,98,0,60,0,98,0,937
 UTOP-OP1 Intermountain Donor Services,Intermountain Donor Services,UTOP,2000,2472,195,,58,206,8,,30,106,97,536,38,,,58,206,58,0,206,58,0,100,0,100,0,58,0,100,0,938
 UTOP-OP1 Intermountain Donor Services,Intermountain Donor Services,UTOP,2001,2602,194,,52,187,7,,27,96,91,535,35,,,52,187,52,0,187,52,0,100,0,100,0,52,0,100,0,939
 UTOP-OP1 Intermountain Donor Services,Intermountain Donor Services,UTOP,2002,2542,191,,60,222,7,,31,116,108,520,43,,,60,222,60,0,222,60,0,100,0,100,0,60,0,100,0,940
 UTOP-OP1 Intermountain Donor Services,Intermountain Donor Services,UTOP,2003,2560,196,,69,246,8,,35,126,119,531,46,,,69,246,69,0,246,69,0,100,0,100,0,69,0,100,0,941
 UTOP-OP1 Intermountain Donor Services,Intermountain Donor Services,UTOP,2004,2447,193,,64,229,8,,33,119,113,526,44,,,64,229,64,0,229,64,0,100,0,100,0,64,0,100,0,942
 UTOP-OP1 Intermountain Donor Services,Intermountain Donor Services,UTOP,2005,2380,203,,66,229,9,,33,113,104,556,41,,,66,229,66,6,223,64,2,97,3,97,3,64,2,97,3,943
 UTOP-OP1 Intermountain Donor Services,Intermountain Donor Services,UTOP,2006,2528,196,,65,232,8,,33,118,112,534,43,,,65,232,65,27,205,54,11,83,17,88,12,54,11,83,17,944
 UTOP-OP1 Intermountain Donor Services,Intermountain Donor Services,UTOP,2007,2520,206,,70,257,8,,34,125,109,559,46,,,70,257,70,27,230,60,10,86,14,89,11,60,10,86,14,945
 UTOP-OP1 Intermountain Donor Services,Intermountain Donor Services,UTOP,2008,2574,235,80,87,287,9,34,37,122,106,640,45,,,87,287,87,70,217,61,26,70,30,76,24,61,26,70,30,946
 UTOP-OP1 Intermountain Donor Services,Intermountain Donor Services,UTOP,2009,2656,257,78,87,288,10,30,34,112,102,698,41,,,87,288,87,72,216,59,28,68,32,75,25,59,28,68,32,947
 UTOP-OP1 Intermountain Donor Services,Intermountain Donor Services,UTOP,2010,2619,257,82,77,287,10,32,30,112,110,702,41,,,77,287,77,19,268,69,8,90,10,93,7,69,8,90,10,948
 UTOP-OP1 Intermountain Donor Services,Intermountain Donor Services,UTOP,2011,2755,236,75,93,314,9,32,39,133,123,640,49,81,87,93,314,93,75,239,61,32,66,34,76,24,61,32,66,34,949
 UTOP-OP1 Intermountain Donor Services,Intermountain Donor Services,UTOP,2012,2717,246,72,83,279,9,29,34,113,105,672,42,85,88,83,279,83,42,237,62,21,75,25,85,15,62,21,75,25,950
 UTOP-OP1 Intermountain Donor Services,Intermountain Donor Services,UTOP,2013,2796,238,94,98,340,9,39,41,143,132,651,52,77,82,98,340,98,51,289,73,25,74,26,85,15,73,25,74,26,951
 UTOP-OP1 Intermountain Donor Services,Intermountain Donor Services,UTOP,2014,2863,274,100,102,359,10,37,37,131,118,743,48,78,82,102,359,102,51,308,78,24,76,24,86,14,78,24,76,24,952
 UTOP-OP1 Intermountain Donor Services,Intermountain Donor Services,UTOP,2015,3014,261,97,99,375,9,37,38,144,134,714,52,80,84,99,375,99,45,330,79,20,80,20,88,12,79,20,80,20,953
 UTOP-OP1 Intermountain Donor Services,Intermountain Donor Services,UTOP,2016,3160,330,103,110,403,10,31,33,122,113,893,45,77,82,110,403,110,65,338,82,28,75,25,84,16,82,28,75,25,954
 VATB-OP1 LifeNet Health,LifeNet Health,VATB,1999,8323,423,,84,308,5,,20,73,62,1191,26,,,84,308,84,3,305,83,1,99,1,99,1,83,1,99,1,955
 VATB-OP1 LifeNet Health,LifeNet Health,VATB,2000,8170,436,,82,315,5,,19,72,63,1232,26,,,82,315,82,2,313,81,1,99,1,99,1,81,1,99,1,956
 VATB-OP1 LifeNet Health,LifeNet Health,VATB,2001,8025,431,,96,358,5,,22,83,73,1207,30,,,96,358,96,6,352,94,2,98,2,98,2,94,2,98,2,957
 VATB-OP1 LifeNet Health,LifeNet Health,VATB,2002,7597,365,,77,253,5,,21,69,64,1017,25,,,77,253,77,20,233,71,6,92,8,92,8,71,6,92,8,958
 VATB-OP1 LifeNet Health,LifeNet Health,VATB,2003,9013,454,,98,344,5,,22,76,68,1270,27,,,98,344,98,14,330,93,5,95,5,96,4,93,5,95,5,959
 VATB-OP1 LifeNet Health,LifeNet Health,VATB,2004,9019,509,,103,355,6,,20,70,62,1419,25,,,103,355,103,17,338,97,6,94,6,95,5,97,6,94,6,960
 VATB-OP1 LifeNet Health,LifeNet Health,VATB,2005,8909,490,,123,446,6,,25,91,78,1361,33,,,123,446,123,35,411,110,13,89,11,92,8,110,13,89,11,961
 VATB-OP1 LifeNet Health,LifeNet Health,VATB,2006,9259,482,,132,486,5,,27,101,87,1342,36,,,132,486,132,36,450,119,13,90,10,93,7,119,13,90,10,962
 VATB-OP1 LifeNet Health,LifeNet Health,VATB,2007,9187,509,,117,397,6,,23,78,67,1408,28,,,117,397,117,42,355,99,18,85,15,89,11,99,18,85,15,963
 VATB-OP1 LifeNet Health,LifeNet Health,VATB,2008,9530,511,173,141,508,5,34,28,99,85,1412,36,,,141,508,141,54,454,120,21,85,15,89,11,120,21,85,15,964
 VATB-OP1 LifeNet Health,LifeNet Health,VATB,2009,9256,494,160,136,467,5,32,28,95,79,1373,34,,,136,467,136,45,422,118,18,87,13,90,10,118,18,87,13,965
 VATB-OP1 LifeNet Health,LifeNet Health,VATB,2010,8917,524,172,147,557,6,33,28,106,90,1452,38,,,147,557,147,52,505,129,18,88,12,91,9,129,18,88,12,966
 VATB-OP1 LifeNet Health,LifeNet Health,VATB,2011,9268,516,166,127,449,6,32,25,87,75,1424,32,64,68,127,449,127,29,420,115,12,91,9,94,6,115,12,91,9,967
 VATB-OP1 LifeNet Health,LifeNet Health,VATB,2012,9031,548,191,179,599,6,35,33,109,87,1514,40,72,77,179,599,179,70,529,151,28,84,16,88,12,151,28,84,16,968
 VATB-OP1 LifeNet Health,LifeNet Health,VATB,2013,9153,527,170,143,502,6,32,27,95,77,1465,34,68,73,143,502,143,60,442,120,23,84,16,88,12,120,23,84,16,969
 VATB-OP1 LifeNet Health,LifeNet Health,VATB,2014,9197,539,156,126,482,6,29,23,89,77,1483,32,71,73,126,482,126,43,439,111,15,88,12,91,9,111,15,88,12,970
 VATB-OP1 LifeNet Health,LifeNet Health,VATB,2015,9123,548,172,153,555,6,31,28,101,85,1514,37,72,76,153,555,153,67,488,128,25,84,16,88,12,128,25,84,16,971
 VATB-OP1 LifeNet Health,LifeNet Health,VATB,2016,8976,558,175,131,506,6,31,23,91,76,1539,33,66,69,131,506,131,29,477,119,12,91,9,94,6,119,12,91,9,972
 WALC-OP1 LifeCenter Northwest,LifeCenter Northwest,WALC,1999,9584,600,,118,470,6,,20,78,65,1669,28,,,118,470,118,0,470,118,0,100,0,100,0,118,0,100,0,973
 WALC-OP1 LifeCenter Northwest,LifeCenter Northwest,WALC,2000,9404,615,,153,580,7,,25,94,81,1702,34,,,153,580,153,6,574,150,3,98,2,99,1,150,3,98,2,974
 WALC-OP1 LifeCenter Northwest,LifeCenter Northwest,WALC,2001,9420,589,,132,513,6,,22,87,75,1628,32,,,132,513,132,4,509,130,2,98,2,99,1,130,2,98,2,975
 WALC-OP1 LifeCenter Northwest,LifeCenter Northwest,WALC,2002,9500,620,,128,479,7,,21,77,71,1709,28,,,128,479,128,4,475,126,2,98,2,99,1,126,2,98,2,976
 WALC-OP1 LifeCenter Northwest,LifeCenter Northwest,WALC,2003,9455,647,,156,564,7,,24,87,76,1778,32,,,156,564,156,46,518,139,17,89,11,92,8,139,17,89,11,977
 WALC-OP1 LifeCenter Northwest,LifeCenter Northwest,WALC,2004,8564,576,,174,632,7,,30,110,100,1589,40,,,174,632,174,93,539,141,33,81,19,85,15,141,33,81,19,978
 WALC-OP1 LifeCenter Northwest,LifeCenter Northwest,WALC,2005,8783,555,,154,513,6,,28,92,81,1527,34,,,154,513,154,74,439,129,25,84,16,86,14,129,25,84,16,979
 WALC-OP1 LifeCenter Northwest,LifeCenter Northwest,WALC,2006,8638,615,,139,491,7,,23,80,66,1689,29,,,139,491,139,72,419,112,27,81,19,85,15,112,27,81,19,980
 WALC-OP1 LifeCenter Northwest,LifeCenter Northwest,WALC,2007,9014,595,,148,570,7,,25,96,86,1635,35,,,148,570,148,53,517,129,19,87,13,91,9,129,19,87,13,981
 WALC-OP1 LifeCenter Northwest,LifeCenter Northwest,WALC,2008,9377,653,185,141,526,7,28,22,81,73,1787,29,,,141,526,141,47,479,124,17,88,12,91,9,124,17,88,12,982
 WALC-OP1 LifeCenter Northwest,LifeCenter Northwest,WALC,2009,9357,649,159,119,482,7,25,18,74,67,1782,27,,,119,482,119,35,447,107,12,90,10,93,7,107,12,90,10,983
 WALC-OP1 LifeCenter Northwest,LifeCenter Northwest,WALC,2010,9061,640,177,142,544,7,28,22,85,74,1761,31,,,142,544,142,51,493,123,19,87,13,91,9,123,19,87,13,984
 WALC-OP1 LifeCenter Northwest,LifeCenter Northwest,WALC,2011,9352,649,166,163,564,7,26,25,87,71,1780,32,75,80,163,564,163,93,471,127,36,78,22,84,16,127,36,78,22,985
 WALC-OP1 LifeCenter Northwest,LifeCenter Northwest,WALC,2012,9579,680,186,176,624,7,27,26,92,77,1868,33,73,78,176,624,176,99,525,135,41,77,23,84,16,135,41,77,23,986
 WALC-OP1 LifeCenter Northwest,LifeCenter Northwest,WALC,2013,9609,689,181,162,595,7,26,23,86,78,1897,31,70,75,162,595,162,80,515,127,35,78,22,87,13,127,35,78,22,987
 WALC-OP1 LifeCenter Northwest,LifeCenter Northwest,WALC,2014,10046,686,173,197,692,7,25,29,101,91,1885,37,73,81,197,692,197,181,511,127,70,64,36,74,26,127,70,64,36,988
 WALC-OP1 LifeCenter Northwest,LifeCenter Northwest,WALC,2015,10453,719,221,200,712,7,31,28,99,89,1982,36,68,74,200,712,200,136,576,150,50,75,25,81,19,150,50,75,25,989
 WALC-OP1 LifeCenter Northwest,LifeCenter Northwest,WALC,2016,10839,733,213,215,782,7,29,29,107,93,2027,39,76,81,215,782,215,142,640,162,53,75,25,82,18,162,53,75,25,990
 WIDN-OP1 Wisconsin Donor Network,Wisconsin Donor Network,WIDN,1999,3446,204,,40,176,6,,20,86,76,582,30,,,40,176,40,0,176,40,0,100,0,100,0,40,0,100,0,991
 WIDN-OP1 Wisconsin Donor Network,Wisconsin Donor Network,WIDN,2000,3497,213,,52,209,6,,24,98,93,598,35,,,52,209,52,0,209,52,0,100,0,100,0,52,0,100,0,992
 WIDN-OP1 Wisconsin Donor Network,Wisconsin Donor Network,WIDN,2001,3330,199,,51,201,6,,26,101,96,557,36,,,51,201,51,2,199,50,1,98,2,99,1,50,1,98,2,993
 WIDN-OP1 Wisconsin Donor Network,Wisconsin Donor Network,WIDN,2002,3335,216,,68,260,6,,31,120,112,601,43,,,68,260,68,2,258,67,1,99,1,99,1,67,1,99,1,994
 WIDN-OP1 Wisconsin Donor Network,Wisconsin Donor Network,WIDN,2003,3220,195,,68,241,6,,35,124,112,542,44,,,68,241,68,13,228,63,5,93,7,95,5,63,5,93,7,995
 WIDN-OP1 Wisconsin Donor Network,Wisconsin Donor Network,WIDN,2004,3174,183,,61,197,6,,33,108,92,501,39,,,61,197,61,12,185,57,4,93,7,94,6,57,4,93,7,996
 WIDN-OP1 Wisconsin Donor Network,Wisconsin Donor Network,WIDN,2005,3000,200,,67,241,7,,34,121,107,551,44,,,67,241,67,5,236,65,2,97,3,98,2,65,2,97,3,997
 WIDN-OP1 Wisconsin Donor Network,Wisconsin Donor Network,WIDN,2006,2879,214,,70,276,7,,33,129,107,580,48,,,70,276,70,18,258,64,6,91,9,93,7,64,6,91,9,998
 WIDN-OP1 Wisconsin Donor Network,Wisconsin Donor Network,WIDN,2007,2817,200,,94,323,7,,47,162,137,549,59,,,94,323,94,58,265,72,22,77,23,82,18,72,22,77,23,999
 WIDN-OP1 Wisconsin Donor Network,Wisconsin Donor Network,WIDN,2008,2840,191,91,91,298,7,48,48,156,130,521,57,,,91,298,91,45,253,74,17,81,19,85,15,74,17,81,19,1000
 WIDN-OP1 Wisconsin Donor Network,Wisconsin Donor Network,WIDN,2009,2746,193,61,63,232,7,32,33,120,93,530,44,,,63,232,63,56,176,45,18,71,29,76,24,45,18,71,29,1001
 WIDN-OP1 Wisconsin Donor Network,Wisconsin Donor Network,WIDN,2010,2737,201,85,79,292,7,42,39,145,126,549,53,,,79,292,79,47,245,63,16,80,20,84,16,63,16,80,20,1002
 WIDN-OP1 Wisconsin Donor Network,Wisconsin Donor Network,WIDN,2011,2598,206,76,72,256,8,37,35,124,103,564,45,72,77,72,256,72,26,230,64,8,89,11,90,10,64,8,89,11,1003
 WIDN-OP1 Wisconsin Donor Network,Wisconsin Donor Network,WIDN,2012,2638,209,69,77,252,8,33,37,121,93,572,44,78,84,77,252,77,26,226,68,9,88,12,90,10,68,9,88,12,1004
 WIDN-OP1 Wisconsin Donor Network,Wisconsin Donor Network,WIDN,2013,2769,221,53,72,229,8,24,33,103,83,602,38,74,84,72,229,72,58,171,51,21,71,29,75,25,51,21,71,29,1005
 WIDN-OP1 Wisconsin Donor Network,Wisconsin Donor Network,WIDN,2014,2898,223,79,72,245,8,35,32,110,89,614,40,75,78,72,245,72,22,223,64,8,89,11,91,9,64,8,89,11,1006
 WIDN-OP1 Wisconsin Donor Network,Wisconsin Donor Network,WIDN,2015,3029,222,70,74,269,7,32,33,121,101,611,44,73,80,74,269,74,56,213,55,19,74,26,79,21,55,19,74,26,1007
 WIDN-OP1 Wisconsin Donor Network,Wisconsin Donor Network,WIDN,2016,3130,240,100,91,346,8,42,38,144,120,654,53,67,73,91,346,91,49,297,74,17,81,19,86,14,74,17,81,19,1008
 WIUW-IO1 UW Health Organ and Tissue Donation,UW Health Organ and Tissue Donation,WIUW,1999,4275,253,,108,462,6,,43,182,175,716,64,,,108,462,108,16,446,103,5,95,5,97,3,103,5,95,5,1009
 WIUW-IO1 UW Health Organ and Tissue Donation,UW Health Organ and Tissue Donation,WIUW,2000,4277,244,,99,374,6,,41,153,141,687,54,,,99,374,99,35,339,87,12,88,12,91,9,87,12,88,12,1010
 WIUW-IO1 UW Health Organ and Tissue Donation,UW Health Organ and Tissue Donation,WIUW,2001,4262,250,,96,386,6,,38,154,146,698,55,,,96,386,96,27,359,87,9,91,9,93,7,87,9,91,9,1011
 WIUW-IO1 UW Health Organ and Tissue Donation,UW Health Organ and Tissue Donation,WIUW,2002,4184,238,,100,407,6,,42,171,157,664,61,,,100,407,100,50,357,86,14,86,14,88,12,86,14,86,14,1012
 WIUW-IO1 UW Health Organ and Tissue Donation,UW Health Organ and Tissue Donation,WIUW,2003,4118,261,,115,427,6,,44,164,148,727,59,,,115,427,115,73,354,89,26,77,23,83,17,89,26,77,23,1013
 WIUW-IO1 UW Health Organ and Tissue Donation,UW Health Organ and Tissue Donation,WIUW,2004,3847,241,,133,462,6,,55,192,173,673,69,,,133,462,133,70,392,107,26,80,20,85,15,107,26,80,20,1014
 WIUW-IO1 UW Health Organ and Tissue Donation,UW Health Organ and Tissue Donation,WIUW,2005,3807,249,,131,495,7,,53,199,183,688,72,,,131,495,131,60,435,108,23,82,18,88,12,108,23,82,18,1015
 WIUW-IO1 UW Health Organ and Tissue Donation,UW Health Organ and Tissue Donation,WIUW,2006,3672,229,,117,411,6,,51,179,159,634,65,,,117,411,117,86,325,87,30,74,26,79,21,87,30,74,26,1016
 WIUW-IO1 UW Health Organ and Tissue Donation,UW Health Organ and Tissue Donation,WIUW,2007,3733,277,,127,417,7,,46,150,131,763,55,,,127,417,127,95,322,89,38,70,30,77,23,89,38,70,30,1017
 WIUW-IO1 UW Health Organ and Tissue Donation,UW Health Organ and Tissue Donation,WIUW,2008,3747,245,117,137,462,7,48,56,188,174,676,68,,,137,462,137,103,359,100,37,73,27,78,22,100,37,73,27,1018
 WIUW-IO1 UW Health Organ and Tissue Donation,UW Health Organ and Tissue Donation,WIUW,2009,3679,246,123,142,499,7,50,58,203,186,674,74,,,142,499,142,98,401,103,39,73,27,80,20,103,39,73,27,1019
 WIUW-IO1 UW Health Organ and Tissue Donation,UW Health Organ and Tissue Donation,WIUW,2010,3693,264,99,115,395,7,37,44,150,133,733,54,,,115,395,115,65,330,92,23,80,20,84,16,92,23,80,20,1020
 WIUW-IO1 UW Health Organ and Tissue Donation,UW Health Organ and Tissue Donation,WIUW,2011,3812,297,103,136,459,8,35,46,155,133,818,56,88,92,136,459,136,103,356,96,40,71,29,78,22,96,40,71,29,1021
 WIUW-IO1 UW Health Organ and Tissue Donation,UW Health Organ and Tissue Donation,WIUW,2012,3590,259,89,115,416,7,34,44,160,141,708,59,93,95,115,416,115,70,346,86,29,75,25,83,17,86,29,75,25,1022
 WIUW-IO1 UW Health Organ and Tissue Donation,UW Health Organ and Tissue Donation,WIUW,2013,3817,264,113,127,479,7,43,48,182,159,731,66,81,85,127,479,127,85,394,95,32,75,25,82,18,95,32,75,25,1023
 WIUW-IO1 UW Health Organ and Tissue Donation,UW Health Organ and Tissue Donation,WIUW,2014,4093,287,101,126,447,7,35,44,156,139,793,56,86,90,126,447,126,111,336,90,36,71,29,75,25,90,36,71,29,1024
 WIUW-IO1 UW Health Organ and Tissue Donation,UW Health Organ and Tissue Donation,WIUW,2015,4148,247,90,106,378,6,36,43,153,140,686,55,83,88,106,378,106,76,302,80,26,75,25,80,20,80,26,75,25,1025
 WIUW-IO1 UW Health Organ and Tissue Donation,UW Health Organ and Tissue Donation,WIUW,2016,4399,310,119,150,504,7,38,48,162,147,865,58,93,95,150,504,150,74,430,118,32,79,21,85,15,118,32,79,21,1026
